爱情万万岁	电视剧
笑傲江湖	电影&电视剧
致青春	电影&电视剧
幻城	电视剧
九州天空城	电视剧
警花与警犬	电视剧
余罪	电视剧
半妖倾城	电视剧
新婚公寓	电视剧
秀丽江山之长歌行	电视剧
好先生	电视剧
鬼同你ot没找到
灭罪师	电视剧
秦时明月	电视剧
任意依恋	电影&电视剧
仙剑云之凡	电视剧
解密	电影&电视剧
花千骨	电影&电视剧
热血没找到
琅琊榜	电视剧
东方战场	电视剧
仙剑奇侠传	电影&电视剧
遇见王沥川	电视剧
新边城浪子	电视剧
海棠依旧	电视剧
小丈夫	电影&电视剧
来自星星的你	电影&电视剧
湄公河大案	电影&电视剧
翻译官	电影&电视剧
多少爱可以重来	电视剧
芈月传	电视剧
伪装者	电影&电视剧
武林外传	电影&电视剧
万万没想到	电影
超少年密码	电视剧
终极一班	电视剧
热血青春	电影&电视剧
追击者	电影&电视剧
六扇门	电视剧
风云年代	电视剧
我的朋友陈白露小姐	电视剧
贴身校花	电视剧
大仙衙门	电视剧
隐形的翅膀	电影&电视剧
她很漂亮	电视剧
信号	电影&电视剧
幸福满屋	电视剧
济公传	电影&电视剧
评价女王	电视剧
三八线	电影&电视剧
还是夫妻	电视剧
我的爱情撞上了战争	电视剧
铁马战车	电视剧
饮食男女	电影&电视剧
鹿鼎记	电影&电视剧
我可能不会爱你	电视剧
中国式关系	电视剧
my盛lady没找到
头号前妻	电视剧
女不强大天不容	电视剧
战争与和平	电影&电视剧
邻家英雄	电视剧
生活有点甜	电视剧
昙花梦	电视剧
我在故宫修文物	电视剧
以和为贵	电视剧
若是如此	电视剧
守护者	电影
为爱所困	电视剧
富贵逼人	电影&电视剧
何以笙箫默	电影&电视剧
锋刃	电视剧
花红花火	电视剧
美女公寓	电影&电视剧
收规华	电视剧
武媚娘传奇	电视剧
荒原	电影
水发胭脂	电视剧
急诊室故事	电视剧
最后的棒棒	电影
美人制造	电视剧
狐仙	电影&电视剧
长沙保卫战	电视剧
冲天	电影
蜀山战纪	电视剧
唐顿庄园没找到
情断上海滩	电视剧
太太万岁	电影&电视剧
校花的贴身高手	电影&电视剧
深圳合租记	电视剧
老炮儿	电影
日落湄南河	电影&电视剧
住在清潭洞	电视剧
妻子的资格	电视剧
蜂蜜蛋糕	电视剧
蜀山战纪之剑侠传奇	电视剧
铁血兄弟	电视剧
顺藤而上的你	电视剧
神秘博士	电影&电视剧
不死法医	电视剧
无心法师	电影&电视剧
偏偏喜欢你	电视剧
飞天大盗	电视剧
x档案没找到
杉杉来了	电视剧
我在天堂等你	电视剧
绛红雪白的花瓣	电视剧
心理罪	电影&电视剧
与狼共舞	电影&电视剧
都市急救线	电视剧
熟男有惑	电视剧
缘海情天	电视剧
爱你所以离开你	电视剧
太空无垠	电视剧
平清盛	电影&电视剧
走马灯株式会社	电视剧
菜市场的爱情	电视剧
拳王	电影&电视剧
不一样的美男子	电视剧
微微一笑很倾城	电影&电视剧
世界上的另一个我	电视剧
诛仙青云志	电视剧
校花的贴身高手2	电视剧
终极一班4	电视剧
嫁个老公过日子	电视剧
神犬小七2	电视剧
怒江之战	电影&电视剧
太子妃升职记	电影&电视剧
谜砂	电视剧
回来吧大叔	电视剧
马兰谣	电视剧
代号	电视剧
只因单身在一起	电视剧
从秦始皇到汉武帝	电视剧
刘海戏金蟾	电视剧
爱情上上签	电影
走出你的爱没找到
欢迎来到皇家别墅	电视剧
无情都市	电视剧
剑侠	电视剧
瑰宝1949	电视剧
天梯	电影&电视剧
隔离七日情	电视剧
白色之恋	电视剧
热海的搜查官	电视剧
东西宫略	电视剧
鱼跃在花见	电视剧
玛丽外宿中	电视剧
家政妇三田	电视剧
第三医院	电视剧
真爱找麻烦	电视剧
龙门驿站	电视剧
夏日甜心	电影&电视剧
光与影	电视剧
暴风雨	电影&电视剧
姐妹	电影&电视剧
少年四大名捕	电视剧
吃亏是福	电影&电视剧
名捕震关东	电视剧
窈窕教主	电视剧
铁马寻桥	电视剧
耀舞长安	电视剧
掌上明珠	电影&电视剧
抓住彩虹的男人	电视剧
妓女谋杀案	电视剧
洪武三十二	电视剧
天天天晴	电视剧
步步杀机	电影&电视剧
汶川故事	电视剧
我的完美男人	电视剧
黑道之家	电视剧
亲爱的公主病	电视剧
你为我着迷	电视剧
我的女友是九尾狐	电视剧
天空之城	电影&电视剧
情越双白线	电视剧
落日余晖	电影&电视剧
怪物小王子	电影&电视剧
大秧歌	电视剧
青岛往事	电视剧
华胥引	电视剧
个人取向	电视剧
亲爱的恩东啊	电视剧
锦绣缘之华丽冒险	电视剧
相爱穿梭千年	电视剧
妈妈像花儿一样	电视剧
人到中年	电影&电视剧
红色	电视剧
天涯明月刀	电影&电视剧
老公万岁	电视剧
勇者无敌	电影&电视剧
同一屋檐下	电影&电视剧
勇士们	电视剧
痞子英雄	电视剧
败犬女王	电视剧
老王同学会	电视剧
天平上的马尔济斯	电视剧
福气又安康	电视剧
孽子	电影&电视剧
流氓校长	电视剧
16个夏天	电视剧
女人30情定水舞间	电视剧
我要变成硬柿子	电视剧
征婚启事	电影&电视剧
爱就宅一起	电视剧
我的宝贝四千金	电视剧
换换爱	电视剧
幸福捕手	电视剧
九指新娘	电视剧
原来是美男	电视剧
超级拍档	电影&电视剧
出外人生	电视剧
我的自由年代	电视剧
幸福选择题	电视剧
太阳的女儿	电影&电视剧
黑糖群侠传	电视剧
我爱你爱你爱我	电视剧
两个爸爸	电影&电视剧
爱神奔驰	电视剧
小站	电影&电视剧
天使之翼	电影&电视剧
木兰花	电影&电视剧
女人香	电影&电视剧
爱情两好三坏	电视剧
温柔的慈悲	电影&电视剧
双璧传说	电视剧
我只在乎你	电影&电视剧
门当户对	电影&电视剧
廉政英雄	电视剧
地下铁	电影&电视剧
苍天有眼	电影&电视剧
失恋高跟鞋	电视剧
秋天的童话	电影&电视剧
钟无艳	电影&电视剧
火线任务	电影&电视剧
真命天女	电视剧
牵纸鹤的手	电视剧
格斗天王	电视剧
爱在我心深处	电视剧
日落之前爱上你	电视剧
家和万事兴	电影&电视剧
蔷薇之恋	电影&电视剧
泡沫之夏	电影&电视剧
青春六人行	电影&电视剧
芳草碧连天	电影&电视剧
天下父母心	电影&电视剧
爱恋狂潮	电视剧
青梅竹马	电影&电视剧
海派甜心	电视剧
下一站幸福	电视剧
熟女欲望日记	电视剧
雪天使	电影&电视剧
桃花小妹	电视剧
天国的嫁衣	电视剧
滚滚血脉	电视剧
下一站，幸福	电影&电视剧
单身宿舍连环泡	电影&电视剧
星愿	电影&电视剧
我在垦丁天气晴	电视剧
爱情来了	电影&电视剧
三明治先生	电视剧
祖师爷的女儿	电视剧
不良笑花	电视剧
多桑与红玫瑰	电视剧
花开花落	电影
霹雳mit没找到
我是男子汉	电影&电视剧
转角遇到爱	电视剧
豪门本色	电视剧
铁树花开	电影&电视剧
18禁不禁	电视剧
大医院小医师	电视剧
黑糖玛奇朵	电视剧
两个门牌一个家	电视剧
爱情烘焙屋没找到
放羊的星星	电视剧
甜柠檬之恋	电视剧
浓情巧克力	电影&电视剧
来我家吧	电视剧
木棉花的春天	电视剧
才子佳人乾隆皇	电视剧
刀歌之多情刀	电视剧
天地有情	电影&电视剧
哈拉教父	电影&电视剧
爱上小男人	电视剧
花样少年少女	电视剧
海誓山盟	电影&电视剧
雍正小蝶年羹尧	电视剧
旧情绵绵	电影&电视剧
香草恋人馆	电视剧
海豚爱上猫	电视剧
大熊医师家	电视剧
燃烧天堂	电视剧
哑巴新娘	电视剧
眉飞色舞	电影&电视剧
孤恋花	电影&电视剧
草山春晖	电视剧
双龙夺凤	电视剧
圣棱的星光	电视剧
绿光森林	电视剧
情定爱琴海	电视剧
我的宠物老公	电视剧
让爱自邮	电视剧
粉红女郎	电影&电视剧
家有菲菲	电视剧
极速传说	电视剧
倩女幽魂	电影&电视剧
明天有你	电视剧
一样的月光	电影&电视剧
千金百分百	电视剧
紫禁之巅	电视剧
情人看招	电视剧
偷偷爱上你	电视剧
粉红教父小甜甜	电视剧
江湖小子	电视剧
明星情人梦	电影
美丽俏佳人	电影&电视剧
南洋奇缘	电影
时来运转	电影&电视剧
明日英雄	电视剧
流星花园2	电视剧
风云1没找到
一切从结婚开始	电视剧
花香番外篇	电视剧
第八号当铺	电视剧
丑女大翻身	电影&电视剧
青蛇外传	电视剧
薰衣草	电影&电视剧
流星花园	电影&电视剧
女生向前走	电视剧
橘子酱男孩	电视剧
格格要出嫁	电视剧
王宝钏与薛平贵	电视剧
戏说慈禧	电视剧
白发魔女	电视剧
怀玉公主	电视剧
乞丐皇帝传奇	电视剧
爱在他乡	电影&电视剧
欢喜人家	电视剧
土地公传奇	电影&电视剧
太阳花	电影&电视剧
挚爱奇缘	电视剧
忠勇小状元	电视剧
非常任务	电影&电视剧
苍天有泪	电视剧
江湖奇侠传	电视剧
一品夫人芝麻官	电视剧
追妻三人行	电视剧
花落花开	电影&电视剧
一门英烈穆桂英	电视剧
婉君	电视剧
星梦泪痕	电影&电视剧
倩女幽魂前传	电视剧
樱花恋	电影
惊世新娘	电影
秦始皇与阿房女	电视剧
海鸥飞处彩云飞	电视剧
梅花三弄之梅花烙	电视剧
梅花三弄之水云间	电视剧
大太监与小木匠	电视剧
英雄少年	电影&电视剧
新白娘子传奇	电视剧
路长情更长	电视剧
江湖再见没找到
家有仙妻	电影&电视剧
小侠龙旋风	电视剧
太阳雨	电影&电视剧
火凤凰	电影&电视剧
你好乔安	电视剧
父母爱情	电影&电视剧
爱情公寓4	电视剧
爱情公寓3	电视剧
十宗罪	电影&电视剧
旋风少女2	电视剧
中国文房四宝	电视剧
平凡的世界	电视剧
少年杨家将	电视剧
酸甜苦辣小夫妻	电视剧
一代枭雄	电影&电视剧
加油吧实习生	电视剧
劝和小组	电视剧
穿越火线	电影&电视剧
醋溜族	电视剧
大汉情缘之云中歌	电视剧
搏击俱乐部没找到
最佳前男友	电视剧
匆匆那年	电影&电视剧
红十字方队	电视剧
延安颂	电视剧
北上广不相信眼泪	电视剧
特警力量	电视剧
爱上查美乐	电视剧
小时代	电影&电视剧
活色生香	电影&电视剧
美丽的秘密	电影&电视剧
今天不上班	电影&电视剧
胡杨女人	电视剧
暗黑者2	电视剧
卫子夫	电视剧
朝内81号	电影&电视剧
小时代1.0折纸时代	电影&电视剧
饥饿的青春没找到
开国元勋朱德	电视剧
大猫儿追爱记	电视剧
井冈山	电影&电视剧
我们家的微幸福生活	电视剧
绝命追踪	电视剧
为了一句话	电视剧
克拉之恋	电视剧
死亡日记	电影&电视剧
港媳嫁到	电视剧
婆媳的战国时代	电视剧
十月围城	电影&电视剧
如果我爱你	电视剧
想明白了再结婚	电视剧
第八日的蝉	电影&电视剧
逃亡者	电影&电视剧
决定不哭的日子	电视剧
怪物	电影&电视剧
三代目明智小五郎没找到
信长协奏曲	电视剧
漫长的告别	电影&电视剧
我的绅士时尚	电视剧
失恋巧克力职人	电视剧
最爱是你	电影&电视剧
我存在的时间	电视剧
我们都是超能者	电视剧
医龙3	电视剧
柏拉图式	电视剧
医龙4	电视剧
一吻定情2	电视剧
全部成为f没找到
父子刑警	电视剧
深夜食堂3	电视剧
紧急审讯室	电视剧
半泽直树	电视剧
纸之月	电影&电视剧
军师官兵卫	电影&电视剧
死神君	电视剧
即便弱小也能获胜	电视剧
关于我的命运	电视剧
花子与安妮	电视剧
地之盐	电视剧
海女	电视剧
夜行摩天轮	电视剧
真奈的诅咒	电视剧
幽灵女友	电视剧
极限	电影
儿媳能使鬼推磨	电视剧
东京风潮	电视剧
云之阶梯	电视剧
胜者即是正义2	电视剧
真幌站前番外地	电视剧
夫妇善哉	电影&电视剧
刑警二人组	电视剧
八重之樱	电视剧
link没找到
飞行员小姐	电视剧
姻缘猎手	电视剧
多谢款待	电视剧
女王牌	电影&电视剧
云雾仁左卫门	电影
垃圾律师	电视剧
庶务二课2013	电视剧
最后的灰姑娘	电视剧
海上诊疗所	电视剧
欢迎来到阴阳屋	电视剧
深夜烘焙坊	电视剧
安堂机器人	电视剧
疑惑	电影&电视剧
敏行快跑	电影&电视剧
鲁邦三世	电影
高中入试	电视剧
最完美的人生终点	电视剧
w的悲剧没找到
儿童警察	电视剧
推定有罪	电影&电视剧
青蛙公主	电影&电视剧
分身	电影&电视剧
康乃馨	电视剧
回我的家	电视剧
岩浆	电影&电视剧
神圣的怪物们	电视剧
单亲妈妈	电影&电视剧
弄假成真	电影&电视剧
必杀仕事人2012	电视剧
青空之卵	电视剧
金牌女王	电视剧
倒数第二次恋爱	电视剧
暗黑女教师	电视剧
樱2号	电视剧
草莓之夜	电影&电视剧
中二病也要谈恋爱！	电视剧
piece没找到
诈欺游戏	电视剧
爱的魔法使	电视剧
毒	电视剧
罪与罚	电影&电视剧
上锁的房间	电视剧
太阳再次升起	电影&电视剧
四重奏	电影&电视剧
丧失名字的女神	电视剧
全开女孩	电视剧
秘密谍报员绘里香	电视剧
深夜食堂2	电视剧
四十九天的秘方	电影&电视剧
老大2	电视剧
真假学园2	电视剧
高护木的规矩	电视剧
邻家美人	电视剧
人间昆虫记	电影&电视剧
暴走医生	电视剧
推理要在晚餐后	电视剧
婆婆侦探团	电视剧
堂吉诃德	电影&电视剧
专业主妇侦探	电视剧
铃木老师	电视剧
最强的名医	电视剧
派对结束	电视剧
荒川爆笑团	电视剧
明日香工高进行曲	电视剧
离婚同居	电视剧
十年之后依然爱你没找到
左眼侦探	电视剧
木更津猫眼	电视剧
紧急救命2	电视剧
月之恋人	电视剧
圈套 新作sp2没找到
不可能没找到
龙马传	电视剧
q10没找到
高濑舟	电视剧
gm～跳舞的医生没找到
虹色夏恋	电视剧
mother没找到
日本人不知道的日语	电视剧
绝对零度	电影&电视剧
你们没有明天	电视剧
无法坦诚相对	电视剧
新参者	电影&电视剧
利家与松	电视剧
真假学园	电视剧
我家的历史	电视剧
桃花期	电影&电视剧
幻夜	电视剧
流星	电影&电视剧
老九门	电视剧
天使之享	电视剧
快感职人	电视剧
毒番茄杀人事件	电视剧
兽医杜立德	电视剧
萤之光2	电视剧
同窗会	电影&电视剧
still life没找到
体操男孩	电视剧
钢之女	电视剧
马克斯之山	电影&电视剧
遥控刑警	电视剧
怨屋本铺2	电视剧
守财奴	电影&电视剧
我的乖乖女	电视剧
新聞速報的流程	电视剧
遥远的羁绊	电视剧
夜光的阶梯	电视剧
上野树里与5个包包	电视剧
面探型男	电视剧
神之水滴	电视剧
音乐孩子王	电视剧
工作狂妈妈	电视剧
父亲大人	电影&电视剧
零秒出手	电视剧
是谁在说谎	电视剧
为爱所困2	电视剧
小别离	电视剧
骄傲的火焰	电视剧
月光皇冠	电视剧
情义两心知	电影&电视剧
明天我依然爱你	电视剧
白莲花	电影&电视剧
公主爱唱歌	电视剧
勿忘我	电影&电视剧
美人计	电影&电视剧
立方体	电影&电视剧
爱情灵药	电影&电视剧
情牵一线	电影&电视剧
前世今生	电影&电视剧
雍正王朝	电视剧
麻雀	电影&电视剧
爱上美人鱼	电影&电视剧
情定菜市场	电视剧
凤凰劫	电影&电视剧
影子姐妹	电视剧
曙光	电影&电视剧
真爱无价	电影&电视剧
折翼天使	电影&电视剧
巧克力情缘	电影&电视剧
野蛮人	电影&电视剧
桃色交易	电影&电视剧
三颗心	电影
千金女佣	电视剧
漫步云端	电视剧
家族禁爱	电视剧
花环夫人	电视剧
爱在路上	电影&电视剧
爱的激荡	电视剧
旋转的爱	电视剧
工厂女孩	电影&电视剧
丘比特的圈套	电视剧
地狱天使	电影&电视剧
我家的恶魔与天使	电视剧
野蛮甜心	电视剧
最后的救赎	电视剧
爱的烹饪法	电视剧
暗香面具	电视剧
女神小姐	电视剧
爱情追踪	电影&电视剧
你是我的生命	电影&电视剧
甜心巧克力	电影&电视剧
破碎的心	电影&电视剧
爱的预言	电视剧
毒爱	电影&电视剧
嫉妒	电影&电视剧
嫉妒的密码	电视剧
满天繁星	电影&电视剧
铁石心肠	电影&电视剧
心的奇迹	电影&电视剧
爱之血系	电视剧
爱对恨错	电视剧
美梦成真	电影&电视剧
心的唯一	电视剧
双生花	电影&电视剧
爱的捆绑	电影&电视剧
爱情降临没找到
爱恨情仇	电影&电视剧
征服死神	电视剧
迷	电影&电视剧
谜	电影
财迷心窍	电影&电视剧
恋恋情深	电影&电视剧
血脉	电影&电视剧
麻辣变形计	电视剧
小偷世家	电视剧
囚徒	电影&电视剧
黑色乌托邦	电视剧
奥丽芙·基特里奇	电视剧
永远的红手带	电影&电视剧
透明人生	电视剧
胡迪尼	电视剧
机器之心	电视剧
结婚为什么	电视剧
七个幸运儿	电视剧
泰坦尼克号	电影&电视剧
灰姑娘与四骑士	电视剧
另类家庭	电视剧
破釜沉舟	电影&电视剧
共同法则	电视剧
直弯好基友	电视剧
神秘河	电影&电视剧
政坛野兽	电视剧
脑力大挑战	电视剧
糖衣陷阱	电影&电视剧
步步惊心：丽	电视剧
天伦	电影&电视剧
少帅	电视剧
狼厅	电视剧
猎人	电影&电视剧
锥子	电视剧
因为爱	电影&电视剧
搭错车	电影&电视剧
欢乐颂	电影&电视剧
潜行者	电影&电视剧
秦始皇	电影&电视剧
红旗渠	电影
奶酪陷阱	电影&电视剧
姐妹兄弟	电影&电视剧
守婚如玉	电视剧
寻味顺德	电视剧
就这样吧没找到
开心原力	电视剧
情归何处	电影&电视剧
最美是你	电视剧
柠檬初上	电视剧
煮妇神探	电视剧
爱的阶梯	电影&电视剧
离亲叛众	电视剧
缪斯之旅	电影
脑洞大开	电影
视线之外	电影&电视剧
解忧公主	电视剧
废柴兄弟4	电视剧
五鼠闹东京	电影&电视剧
你是我的眼	电影&电视剧
太阳的后裔	电影&电视剧
女人的天空	电影&电视剧
女医明妃传	电视剧
彭德怀元帅	电视剧
情谜睡美人	电视剧
我是杜拉拉	电视剧
新萧十一郎	电视剧
旋风十一人	电视剧
无理的前进	电视剧
最好的我们	电影&电视剧
武神赵子龙	电视剧
父亲的身份	电视剧
英伦魔法师	电影&电视剧
都市妖奇谈	电视剧
青丘狐传说	电视剧
亲爱的翻译官	电视剧
我的博士老公	电视剧
我的奇妙男友	电视剧
我的校花妹妹2	电影
十五年等待候鸟	电视剧
因为爱情有幸福	电视剧
奇妙的时光之旅	电视剧
奶爸的爱情生活	电视剧
寂寞空庭春欲晚	电视剧
欢天喜地对亲家	电影&电视剧
生命中的好日子	电视剧
远得要命的爱情	电视剧
重生之名流巨星	电视剧
山海经之赤影传说	电视剧
暴走大事件第四季	电视剧
睡在我上铺的兄弟	电影&电视剧
那年青春我们正好	电视剧
我叫郝聪明之笨蛋爱上两个你	电视剧
宰相刘罗锅	电视剧
还珠格格	电视剧
鸿运赛马	电视剧
死亡痕迹	电视剧
步步惊心	电影&电视剧
霹雳娇娃	电影&电视剧
幻世浮生	电视剧
非凡家庭	电视剧
真相背后	电影&电视剧
狼门血影	电视剧
伴我双飞	电视剧
恋爱中的女人	电影&电视剧
情迷画色	电影&电视剧
偶发空缺	电视剧
死亡片场	电视剧
毒夫	电视剧
记忆	电影&电视剧
南方与北方	电影&电视剧
卡萨诺瓦	电影&电视剧
小镇疑云	电影
内鬼	电影&电视剧
渐行渐远	电影&电视剧
队列之末	电视剧
大堡礁	电影&电视剧
公众之敌	电影&电视剧
梦幻岛	电影&电视剧
正义没找到
血和油	电视剧
航海帝国	电视剧
money没找到
爱丽丝	电影&电视剧
神盾局	电视剧
春天的希望	电影&电视剧
呼啸山庄	电影&电视剧
三尖树时代	电影&电视剧
十一先生	电视剧
男女变错身	电影&电视剧
凶杀之地	电视剧
中间人2	电影
基督教历史	电视剧
理智与情感	电影&电视剧
萨达姆家族	电视剧
德伯家的苔丝	电视剧
罪恶之城	电影&电视剧
地下判官	电视剧
笑面之下	电视剧
迷失奥斯丁	电影&电视剧
小杜丽	电影&电视剧
非完美藏身	电视剧
情感顾问团	电视剧
变身怪医	电影&电视剧
加拉帕戈斯群岛	电视剧
原罪	电影&电视剧
地球脉动	电影&电视剧
与巨兽同行	电影
莎士比亚重现	电视剧
命案目睹记	电影
羽毛男孩	电视剧
三生三世十里桃花	电影&电视剧
政局密云	电影&电视剧
发酵家族	电视剧
龙八夷	电视剧
上流社会	电影&电视剧
陷入纯情	电视剧
面包王金卓求	电视剧
间谍明月	电视剧
记得你	电视剧
哦我的鬼神大人	电视剧
假面	电影
总统	电影&电视剧
匹诺曹	电影&电视剧
治愈者	电视剧
谢谢	电视剧
制片人	电影&电视剧
诱惑	电影&电视剧
看见味道的少女	电视剧
扑通扑通love没找到
离婚律师恋爱中	电视剧
doctor异乡人没找到
微生物	电视剧
爱你的时间	电视剧
秘密之门	电影
百年的新娘	电视剧
不要恋爱要结婚	电视剧
暧昧	电影
黄金交叉	电视剧
摩登农夫	电视剧
钢铁人	电影&电视剧
我要结婚的理由	电影
危情三日	电影&电视剧
岬童夷	电视剧
hotel king没找到
宥娜的街	电视剧
坏家伙们	电影&电视剧
你们被包围了	电视剧
不一样的哭泣	电影
继承者们	电影&电视剧
朝鲜神枪手	电视剧
剩余公主	电视剧
恋爱的发现	电视剧
三剑客	电影&电视剧
花样爷爷调查队	电视剧
无尽的爱	电影&电视剧
哭婢	电影
主君的太阳	电视剧
魔女的恋爱	电视剧
我们可以相爱吗	电视剧
追踪者	电影&电视剧
请回答1997	电视剧
青春期集成曲	电视剧
荆棘花	电影&电视剧
三生	电影
梦幻情侣	电视剧
九家之书	电视剧
两周	电影&电视剧
七级公务员	电影&电视剧
一起用餐吧	电视剧
老大	电视剧
nine：九回时间旅行没找到
野王	电视剧
绅士的品格	电影&电视剧
the virus没找到
女王的教室	电视剧
monstar没找到
回来吧顺爱	电视剧
公主回来了	电视剧
漂亮男人	电视剧
天下绝色朴贞琴	电视剧
奇皇后	电视剧
未来的选择	电视剧
善良的男人	电视剧
世界的尽头	电影
欧若拉公主	电视剧
二十岁	电影&电视剧
特殊案件专案组ten2没找到
总理和我	电视剧
hero没找到
刀手吴水晶	电视剧
黄金帝国	电视剧
结婚的女神	电视剧
嫉妒的化身	电视剧
期待恋爱	电视剧
清潭洞111	电视剧
邻家花美男	电视剧
韩半岛	电影&电视剧
我们可以结婚吗	电视剧
你来自哪颗星	电视剧
清潭洞爱丽丝	电视剧
我愿意	电影&电视剧
家族的诞生	电影&电视剧
我的爱	电影
仁显王后的男人	电视剧
追梦高中2	电视剧
城市猎人	电影&电视剧
屋塔房王世子	电视剧
美味人生	电影&电视剧
五指	电影&电视剧
阿娘使道传	电视剧
神的晚餐	电影&电视剧
学校2013	电视剧
玻璃假面	电视剧
sign没找到
快乐的结局	电影&电视剧
想你	电视剧
big没找到
时尚王	电影&电视剧
不朽的名作	电影&电视剧
一闪一闪亮晶晶	电影&电视剧
相信男人	电影&电视剧
火鸟	电影&电视剧
树大根深	电影&电视剧
豪门	电视剧
what's up没找到
皇室家族	电视剧
特殊案件专案组ten没找到
绝顶	电影&电视剧
对我说谎试试	电视剧
公主的男人	电视剧
死因	电视剧
伙伴	电影&电视剧
守护boss没找到
我的爱在我身边	电影&电视剧
最佳爱情	电视剧
美丽的母亲	电视剧
爱上女主播	电影&电视剧
逆转女王	电视剧
成均馆绯闻	电视剧
检察官公主	电视剧
三姐妹	电影&电视剧
近肖古王	电视剧
我的女郎	电视剧
灰姑娘的姐姐	电视剧
大嫁风尚	电视剧
奇怪的英雄	电视剧
坏男人	电视剧
巨人	电影&电视剧
邻居冤家	电视剧
红字	电影&电视剧
原来是美男啊	电视剧
男人的故事	电视剧
灿烂的遗产	电视剧
市政厅	电影&电视剧
拜托小姐	电视剧
泰熙慧乔智贤	电视剧
旋转木马	电影&电视剧
三个男人没找到
花样男子	电影&电视剧
回家的路	电影&电视剧
圣诞节会下雪吗没找到
搭档	电影
垂涎之岛	电视剧
绿色马车	电视剧
iris没找到
松药店的儿子们	电视剧
傻瓜	电影
纯情	电影&电视剧
圣诞节会下雪吗？	电影&电视剧
不能结婚的男人	电视剧
玻璃之城	电影&电视剧
春子家有喜事了	电视剧
单身爸爸恋爱中	电视剧
风之画员	电视剧
法庭风云	电视剧
玻璃鞋	电影&电视剧
三个爸爸一个妈妈	电视剧
家门的荣光	电视剧
他们的世界	电影&电视剧
首尔武林传	电视剧
我们这一家	电影&电视剧
一枝梅	电影&电视剧
水瓶座	电影&电视剧
恋爱兵法	电影&电视剧
无赖汉	电影
爱情正在直播	电视剧
回来的大酱汤锅	电视剧
东京太阳雨	电视剧
全职妈妈没找到
传说中的故乡	电影&电视剧
伊甸之东	电视剧
我被你迷住了	电视剧
猫屎妈妈	电视剧
廉政行动2011	电视剧
毕打自己人	电视剧
万凰之王	电视剧
翻叮一族	电视剧
九江十二坊	电视剧
神探高伦布	电视剧
森之爱情	电视剧
原来爱上贼	电视剧
碧血盐枭	电视剧
楼奴	电视剧
陪着你走	电影&电视剧
摘星之旅	电视剧
请回答1988	电视剧
无双谱	电视剧
宦海奇官	电视剧
太极	电影&电视剧
忠奸人	电影&电视剧
名门暗战	电视剧
野蛮奶奶大战戈师奶	电视剧
银楼金粉	电视剧
八卦神探	电视剧
飞虎2	电视剧
守业者	电视剧
学警出更	电视剧
爱我请留言	电视剧
金枝欲孽2	电视剧
叛逃	电视剧
法外风云	电视剧
写意人生	电视剧
好心作怪	电视剧
冲上云霄2	电视剧
巾帼枭雄之谍血长天	电视剧
巨轮	电影&电视剧
情逆三世缘	电视剧
神枪狙击	电视剧
岁月风云	电视剧
两妻时代	电视剧
火舞黄沙	电影&电视剧
当旺爸爸	电视剧
大太监	电影&电视剧
帝女花	电影&电视剧
雷霆扫毒	电视剧
男人之苦	电影&电视剧
飞虎	电影&电视剧
名媛望族	电视剧
香港奇案实录	电视剧
换乐无穷	电视剧
凤凰四重奏	电视剧
东方之珠	电视剧
爱·回家	电影&电视剧
叠影危情	电视剧
乱世佳人	电影&电视剧
巴不得妈妈...	电视剧
子是故人来	电视剧
上海传奇	电影&电视剧
法证先锋3	电视剧
only you 只有您没找到
争分夺秒	电影&电视剧
恋香	电视剧
女拳	电视剧
甜孙爷爷	电视剧
识法代言人	电视剧
荃加福禄寿探案	电视剧
不速之约	电视剧
水浒无间道	电视剧
点指贼贼贼捉贼	电视剧
点解阿sir系阿sir没找到
心战	电影&电视剧
我的如意狼君	电视剧
胭脂水粉	电视剧
怒火街头	电影&电视剧
隔世追凶	电视剧
囧探查过界	电视剧
读心神探	电视剧
安逗与黑仔	电视剧
女人最痛	电影&电视剧
当四叶草碰上剑尖时	电视剧
刁蛮娇妻苏小妹	电视剧
画舫风云	电视剧
巾帼枭雄2	电视剧
骇客军团	电影&电视剧
公主嫁到	电视剧
机器人先生	电视剧
超越罪恶 第五季	电视剧
胜者为王4争霸	电视剧
制毒师 第五季	电视剧
谈情说案	电视剧
硅谷群瞎传(台)	电视剧
硅谷黑历史	电视剧
最后一艘船	电视剧
末世之舟	电视剧
烈火雄心3	电视剧
法戈市	电视剧
古灵精探2	电视剧
巾帼枭雄	电视剧
食脑外星人	电视剧
黑夜彩虹	电视剧
六人行 第十季	电视剧
古灵精探b没找到
都市六人行 第十季	电视剧
李克用与十三太保	电视剧
战火兄弟连	电影&电视剧
诺曼第大空降	电视剧
功夫足球	电视剧
财富战争(港)	电视剧
财富之战	电视剧
id精英没找到
铁窗红颜	电影&电视剧
王老虎抢亲	电影&电视剧
微不足道的生活没找到
打工姐妹花 第五季	电视剧
一家之主 第一季	电视剧
山丘之王 第一季	电视剧
阴尸路	电视剧
男亲女爱	电视剧
线人 第五季	电视剧
HBO无间行者 第五季	电视剧
宫心计	电视剧
幕后大老爷	电视剧
探险时光	电影&电视剧
调教宝典	电视剧
伏从	电视剧
金牌冰人	电视剧
无耻家庭(美版) 第六季	电视剧
婚外情	电影&电视剧
跟红顶白大三元	电视剧
情事	电影&电视剧
你最渣	电视剧
你最坏了	电视剧
绝代商骄	电视剧
老婆大人ii没找到
新闻间轶事	电视剧
新闻中心	电视剧
八号巴士	电视剧
欲海情魔	电影&电视剧
米尔德丽德·皮尔斯	电视剧
欲海浮生	电影
色欲都市 第六季	电视剧
欲望城市 第六季	电视剧
欲望都市	电影
侠骨仁心	电影&电视剧
基本演绎法	电视剧
郑板桥	电视剧
法网伊人	电视剧
失落的房间没找到
盛装舞步爱作战	电视剧
密室惊魂	电视剧
情事缉私档案	电视剧
小鱼儿与花无缺	电视剧
美国怪谭：旅馆	电视剧
欲望绝情妻 第八季	电视剧
靓太唔易做(港) 第八季	电视剧
医神 第八季	电视剧
流氓医生 第八季	电视剧
齐天大圣孙悟空	电视剧
疑情别恋	电视剧
人芯	电视剧
骑呢大状	电视剧
Gotham: Rise of the Villains	电视剧
法证先锋2	电视剧
食神	电影&电视剧
唱片启示录(台)	电视剧
雷霆战海(港)	电视剧
血战太平洋	电视剧
澳门街	电影&电视剧
古灵精探	电视剧
为酒而狂	电视剧
Baccano!	电视剧
黑道家族 大结局	电视剧
老爸老妈罗曼史 第九季	电视剧
梦想的天空	电影
HIMYM 9	电视剧
双峰镇 第二季	电视剧
彩色世界	电视剧
夜魔侠	电影&电视剧
我的外母唔系人没找到
迎妻接福	电影
杀戮 第四季	电视剧
神秘谋杀 第四季	电视剧
春蚕织梦	电视剧
星际迷航：原初系列 第二季	电视剧
星际争霸战(台)：初代 第二季	电视剧
武十郎	电视剧
不是冤家不聚头 第六季	电视剧
补习天后	电视剧
猫鼠游戏 第六季	电视剧
锦衣卫	电影&电视剧
诉讼双雄 第五季	电视剧
不朽法医	电视剧
永恒	电影
公私恋事多	电视剧
飞出个未来	电视剧
祖先开眼	电视剧
急火攻芯	电视剧
电脑狂人	电视剧
嫁错妈	电视剧
女孩我最大 第五季(台)	电视剧
衰姐们 第五季	电视剧
a计划没找到
Cobalt	电视剧
通天干探	电视剧
Fear of The Walking Dead	电视剧
新生无间道	电视剧
训练营黑历史	电视剧
凶城计中计	电视剧
十六不搭喜趣来	电视剧
六尺风云 第五季	电视剧
宠物情缘	电影&电视剧
英国恐怖故事	电视剧
潘妮的恐惧	电影&电视剧
天才刑法班	电视剧
莫让情两难	电视剧
宁静号	电影&电视剧
园墙之上	电视剧
飞越院墙	电视剧
大城小故事	电视剧
篱笆墙外	电影
春光乍洩	电影
汇通天下	电视剧
紐約醫情（台）	电视剧
非常大状	电视剧
铁血保镖	电视剧
丧尸国度	电视剧
我来自潮州	电视剧
24小时反恐部队 第八季	电视剧
楼住有情人	电视剧
反恐24小时 第八季	电视剧
撕逼帝国	电视剧
迷离魔界 第一季	电视剧
阴阳魔界 第一季	电视剧
覆雨翻云	电视剧
凶鬼恶灵 第十一季	电视剧
法证先锋	电视剧
超自然 第十一季	电视剧
天王状师	电视剧
高城堡里的人	电视剧
茶是故乡浓	电视剧
丑陋的美国人	电影&电视剧
刑事情报科	电视剧
飞短留长父子兵	电视剧
宋飞正传	电视剧
王者风云	电视剧
CIA特勤秘辛(台)	电视剧
公司没找到
大冒险家	电影&电视剧
二当家	电视剧
超级女孩	电影&电视剧
盲侠金鱼飞天猪	电视剧
女超人	电影&电视剧
老妈没找到
母亲大人	电视剧
同志亦常人 第五季	电视剧
男版欲望都市 第五季	电视剧
纽约浮牲录	电视剧
妮基塔女郎 第四季	电视剧
嗜血娇娃 第四季	电视剧
妙手仁心3	电视剧
罗马帝国 第二季	电视剧
罗马	电影&电视剧
八卦天后 第六季	电视剧
绯闻少女 第六季	电视剧
天下第一	电影&电视剧
万事胜意	电影&电视剧
众里寻他 第二季	电视剧
美国天使	电视剧
这个警察有点烦 第三季	电视剧
布鲁克林奶奶	电视剧
学警雄心	电视剧
绿箭 第四季	电视剧
Green Arrow Season 4	电视剧
危险人物	电影&电视剧
Popeye	电视剧
窈窕熟女	电视剧
大力水手	电影&电视剧
律师风云 第五季	电视剧
波士顿法律 第五季	电视剧
Little Mouse on the Prairie	电视剧
大草原上的小老鼠	电视剧
外包公司	电视剧
外乡人	电影&电视剧
异乡人	电影&电视剧
太空堡垒卡拉狄加	电视剧
致命美人 第二季	电视剧
致命的女性 第二季	电视剧
随时候命	电视剧
报仇雪恨 第四季	电视剧
冲上人间	电视剧
遗世者 第二季	电视剧
血肉之躯	电影&电视剧
一团糟	电视剧
切尔西综合医院	电视剧
深入恶土	电视剧
翻新大少	电视剧
荒芜之地	电影&电视剧
穷山恶水	电影
功夫状元	电视剧
杰斯卡·琼斯	电视剧
杰茜卡·琼斯	电视剧
卡特探员	电视剧
我爱钟无艳	电视剧
拯救肯尼迪	电视剧
我师傅是黄飞鸿	电视剧
惊魂日	电视剧
11.22.63	电视剧
沙娜拉之剑	电影&电视剧
天子寻龙	电视剧
大学生费莉希蒂	电视剧
幸福	电影
费利西蒂	电影
三宝医馆	电视剧
圆月弯刀	电影&电视剧
情人	电影&电视剧
春心荡漾	电影&电视剧
扫黄先锋	电视剧
黑名单	电影&电视剧
美味天王	电视剧
DC明日传奇	电视剧
DC's Legends of Tomorrow	电视剧
无垠的太空	电视剧
天地男儿	电视剧
路易的故事	电视剧
900重案追凶	电视剧
游侠	电影
女国务卿	电视剧
国务卿夫人	电视剧
惊魂序曲	电视剧
贝兹汽车旅馆	电视剧
廉政行动2004	电视剧
尖叫女皇 第一季	电视剧
灵异侦缉档案2	电视剧
迷离档案	电影&电视剧
天兵公园(台)	电视剧
日常参考	电视剧
Teenage Mutant Hero Turtles	电视剧
超能英雄 第四季	电视剧
变种群英 第四季	电视剧
金枝欲孽	电视剧
老爸爱变装	电视剧
廉政追缉令	电视剧
富豪海湾至尊家缘	电视剧
罪恶的美国	电视剧
美国罪恶	电影&电视剧
下一站彩虹	电视剧
走进西部	电视剧
桃花源记	电影&电视剧
西部风云史	电视剧
恐怖大师	电影&电视剧
我所谓的生活	电视剧
阿甘妙世界(台)	电视剧
栋笃神探	电视剧
卡姆鲍尔的奇妙世界	电视剧
网上有情人	电视剧
伊拉克战争亲历记	电视剧
纵横天下	电影&电视剧
童话归来	电视剧
宽镇日常	电视剧
律政新人王	电视剧
开放之城	电视剧
妙女双姝	电视剧
双生	电影
白宫群英 第七季	电视剧
无处逃生	电影&电视剧
Cordon	电影&电视剧
智击特工(港)	电视剧
智勇新警界	电视剧
失去记忆的杀手没找到
达米安	电视剧
Popeye the Sailor	电影
金手指	电影&电视剧
老公老婆不登对 第一季	电视剧
格蕾丝与弗兰基	电影&电视剧
亚洲英雄	电视剧
星际迷航：下一代 第一季	电视剧
星际争霸战(台)：下一代 第一季	电视剧
谜情家族	电视剧
恋爱自由式	电视剧
金色年代	电影&电视剧
洗冤录2	电视剧
卫斯理	电影&电视剧
时势造英雄(港)	电视剧
给我一个英雄	电视剧
十万吨情缘	电视剧
皇家反千组	电视剧
12 Maymun	电视剧
蝎子网络	电视剧
天蝎计划	电视剧
皆大欢喜时装版	电视剧
希区柯克悬念故事集	电视剧
希治阁剧场(港)	电视剧
英雄刀少年	电视剧
超级监狱	电视剧
地球最后一人	电影&电视剧
地球上最后一个人	电影&电视剧
美人不可貌相	电视剧
扑水冤家	电视剧
雷·多诺万	电视剧
陀枪师姐4	电视剧
奔月	电视剧
几近为人	电视剧
达·芬奇的魔鬼	电视剧
情牵百子柜	电视剧
费城阳光	电视剧
雄心密令	电视剧
新探案	电视剧
抢杠夫妻	电视剧
葡萄园战火	电视剧
直到再相逢	电视剧
真假东宫	电视剧
天降奇缘	电影&电视剧
少年奶爸	电视剧
无考不成冤家	电视剧
河东狮吼	电影&电视剧
致命诱惑	电影&电视剧
如来神掌	电影&电视剧
直弯拍档	电视剧
真爱拍档	电视剧
绝对界限	电视剧
界限	电影&电视剧
九层糕	电视剧
憨夫成龙	电视剧
公园与休憩	电视剧
情浓大地	电视剧
疯狂广告人	电影&电视剧
烈火雄心2	电视剧
缉私群英	电视剧
红衣手记	电视剧
第三类法庭	电视剧
劫持	电影&电视剧
正义超人联盟没找到
倚天剑屠龙刀	电视剧
正义联盟	电影&电视剧
寄养一家人	电视剧
如此一家人	电视剧
陀枪师姐3	电视剧
碧血青天珍珠旗	电视剧
百变显神通	电影
非常好警	电视剧
烧饼皇后	电视剧
矫正人生(台)	电视剧
重生	电影&电视剧
风城烈火 第二季	电视剧
芝加哥警局	电视剧
潜龙谍影	电视剧
娱乐反斗星	电视剧
传奇	电影
犯罪现场迈阿密篇 第十季	电视剧
鉴证行动组：迈阿密 第十季	电视剧
马场大亨	电视剧
丑闻风暴	电影&电视剧
洪熙官	电影&电视剧
蓝色月光侦探社	电视剧
大捕快	电视剧
双面娇娃(台)	电视剧
机器娃娃 第一季	电视剧
南龙北凤	电影&电视剧
男人四十一头家	电视剧
白发魔女传	电影&电视剧
烈爱伤痕	电视剧
前世冤家	电视剧
美国老豆	电视剧
无业楼民	电视剧
别无选择	电影&电视剧
新常态 第一季	电视剧
基本正常 第一季	电视剧
武尊少林	电视剧
律政佳人	电影&电视剧
小熊威克	电影
妙手仁心2	电视剧
艾莉的异想世界	电视剧
美味情缘	电影&电视剧
胜利之歌	电影&电视剧
麦克和茉莉 第二季	电视剧
肥肥和胖胖 第二季	电视剧
天地传说之鱼美人	电视剧
天堂执法者 第四季	电视剧
H5O S4	电视剧
缘份无边界	电视剧
医神华佗	电视剧
梦想成真	电影&电视剧
奇人奇案	电视剧
侠女闯天关	电视剧
圈叉医院 第一季	电视剧
Dexter's Lab  Season 2	电视剧
Dexter de Shiyanshi Season 2	电视剧
半路奶爸 第四季	电视剧
机械战警：基本指令	电视剧
铁甲威龙：基本指令	电视剧
雷霆第一关	电视剧
镜花缘传奇	电视剧
血玺金刀	电视剧
海格力斯	电影&电视剧
鉴证实录2	电视剧
吾系差人	电视剧
始祖家族	电视剧
吸血鬼家族	电影&电视剧
反黑先锋	电视剧
边城浪子	电影&电视剧
少年英雄方世玉	电视剧
死亡地带	电影&电视剧
杀手之王	电影&电视剧
人龙传说	电视剧
千里姻缘兜错圈	电视剧
单身公寓	电影&电视剧
尾行者	电视剧
原振侠	电视剧
烈火雄风	电视剧
超人前传	电视剧
Les minipouss	电视剧
小不点	电影&电视剧
刑事侦缉档案4	电视剧
风云岁月	电影&电视剧
保镖之情人保镖	电视剧
自梳女	电影&电视剧
天下有情之天涯路	电视剧
外父唔怕做	电视剧
天地无情	电视剧
爱在暴风的日子	电视剧
绝地苍狼	电视剧
西游记2没找到
还我今生	电视剧
妙手仁心	电视剧
超人新冒险	电视剧
怒剑啸狂沙	电视剧
露易斯和克拉克：超人新冒险	电视剧
我本善良	电视剧
冥侦探艾艾 第二季	电视剧
转世还阳 第二季	电视剧
上海之恋	电影&电视剧
新成长的烦恼 第二季	电视剧
我和僵尸有个约会1	电视剧
平民天后 第二季	电视剧
欢喜游龙	电视剧
婚姻狂想曲	电视剧
天地豪情	电视剧
新少林五祖	电影&电视剧
冤家宜结不宜解	电视剧
邪恶女巫	电影
师奶强人	电视剧
101斑点狗	电影&电视剧
法网柔情	电视剧
圣女简恩	电影&电视剧
真爱好孕到(台)	电视剧
意外之孕	电影
浪族阔少爷	电视剧
政治动物	电视剧
少数派报告电视剧版	电视剧
烈火雄心	电影&电视剧
断头谷	电影&电视剧
香港人在广州	电视剧
米勒一家	电视剧
新江山美人	电影&电视剧
万兽之地	电视剧
特种部队：眼镜蛇复仇记	电视剧
特种部队：蛇族复仇	电视剧
急诊室的春天 第十二季	电视剧
乐坛插班生	电视剧
保护证人组	电视剧
欲海医心	电视剧
鉴证实录	电视剧
郊区是监狱	电视剧
郊区炼狱	电视剧
宇宙的巨人希曼	电影&电视剧
He-Man	电影&电视剧
鬼玩人之阿什斗厉鬼	电视剧
肥猫正传	电视剧
我为喜剧狂	电视剧
回到未嫁时	电视剧
人海骄阳	电视剧
南海十三郎	电影&电视剧
刑事侦缉档案3	电视剧
体操公主	电视剧
康熙王朝	电视剧
大闹广昌隆	电影&电视剧
俏妈新上路	电视剧
反贪风暴	电影&电视剧
隐形怪杰	电视剧
等着你回来	电影&电视剧
苗翠花	电视剧
义不容情	电影&电视剧
非凡的希瑞公主	电视剧
难兄难弟	电影&电视剧
希拉没找到
铁血大旗门	电视剧
廉政行动1996	电视剧
他来自江湖	电视剧
泛美之旅	电视剧
聊斋之流光情劫	电视剧
星际之门 SG-1  第一季	电视剧
廉政行动组	电视剧
五个醒觉的少年	电视剧
聊斋之侠女田郎	电视剧
查理的天使没找到
吉星报喜	电视剧
天赐凯尔 第三季	电视剧
成长之痛 第七季	电视剧
有肥人终成眷属	电视剧
还我正义	电视剧
玛丽苏春天	电视剧
武当张三丰	电视剧
欧洲民间故事	电视剧
路客与刀客	电影&电视剧
外国真人童话集	电影&电视剧
太空堡垒卡拉狄加 电视迷你剧	电视剧
太空战星	电视剧
远方	电影
飘零燕	电影&电视剧
刑事侦缉档案	电视剧
刑事侦缉档案2	电视剧
精武门	电影&电视剧
新同居关系	电视剧
The Spooktacular New Adventures of Casper	电视剧
一切从失踪开始	电视剧
僵尸领地	电影&电视剧
廉政英雌之火枪柔情	电视剧
Zombieland The Series	电视剧
孝感动天	电影&电视剧
加菲猫	电影&电视剧
加菲猫和他的朋友	电视剧
劳拉的秘密没找到
万里长情	电视剧
表面之下	电视剧
o记实录没找到
Batman: The Animated Series	电视剧
一夫三妻	电视剧
幸福终点站	电影&电视剧
美国人	电影&电视剧
赤色公民	电视剧
冷战谍梦（台译）	电视剧
好运查莉	电视剧
The Tom and Jerry Comedy Show	电影
双龙记	电影&电视剧
餐餐有宋家	电视剧
方世玉与乾隆皇	电视剧
戏王之王	电影&电视剧
弗林特斯通一家	电视剧
聪明笨伯	电影&电视剧
神秘之河	电影&电视剧
河流	电影
生命之旅	电影&电视剧
超级科学战队	电影
妙探出租	电视剧
癌莫能助	电视剧
婚姻物语	电视剧
飞花逐月	电视剧
阳光大龄男	电视剧
异度凶情	电视剧
好友也上床	电视剧
流氓大亨	电影&电视剧
泰若星球	电影&电视剧
枪神	电影&电视剧
魔刀侠情	电视剧
精武五虎	电视剧
天龙神剑	电视剧
德雷斯顿谜案	电视剧
灵异档案	电影&电视剧
少年五虎	电视剧
富贵冤家	电视剧
刺猬索尼克	电影&电视剧
谍影重重	电影&电视剧
家庭战争	电视剧
失踪	电影
黑书 第三季	电视剧
布莱克书店 第三季	电视剧
相对无言	电视剧
暴发户	电影&电视剧
鹊起之鸦	电视剧
新生代侦探	电视剧
新一代	电视剧
锲而不舍 第三季	电视剧
伦敦间谍	电视剧
伦敦特工	电视剧
当我们同在一起	电影&电视剧
错有错招	电视剧
拾梦记 (台)	电视剧
丝袍 第三季	电视剧
布莱切利小组	电视剧
爱玛	电视剧
盗你没商量 第八季	电视剧
大侦探波洛探案传奇	电视剧
添丁发财	电影&电视剧
在别处 第二季	电视剧
异度人生 第二季	电视剧
被告  第二季	电视剧
是，大臣：党派之戏	电视剧
幸运星	电影&电视剧
绝对佳人	电视剧
行尸肉心	电视剧
快活谷	电视剧
欢乐谷	电影&电视剧
蚂蚁“烂”漫曲 第二季	电视剧
简·爱	电影&电视剧
超時空奇俠（台）	电视剧
莫内和他的朋友们(台)没找到
幸福双人床	电视剧
印象派	电视剧
活下去	电影&电视剧
幕后危机	电视剧
靠谱恋爱 第四季	电视剧
冤家对对碰 第四季	电视剧
梦想动物园	电视剧
Shakespeare Retold	电视剧
小城大事	电影&电视剧
马普尔小姐 第六季	电视剧
Agatha Christie's Marple Season 6	电视剧
二分之一缘分	电视剧
小猪佩琦	电视剧
小猪佩奇	电视剧
英语课	电视剧
请讲普通话 第三季	电视剧
危情时刻 第二季	电视剧
新闻狂人 第二季	电视剧
归来记	电视剧
梅林	电影&电视剧
孤男寡女	电影&电视剧
海的儿子	电影&电视剧
真爱	电影&电视剧
可敬的女人	电视剧
谍影巾帼	电视剧
生日快乐	电影&电视剧
天线得得B	电影
剑桥间谍没找到
喋血街头 第三季	电视剧
宅男腐女	电视剧
屌丝情侣	电视剧
美丽人生	电影&电视剧
Dr. Who	电视剧
癫狂中学	电视剧
猎杀行动	电视剧
猎捕	电影&电视剧
反恐谍报战(台) 第九季	电视剧
谍影生涯 第九季	电视剧
球爱大战	电视剧
一房半厅一水缸	电影
伴我飞翔	电影&电视剧
嘻哈机场	电视剧
摄位人 第二季	电视剧
随心所遇	电视剧
汤玛斯和朋友伟大的发现	电视剧
托马斯和他的朋友们没找到
叮当神探	电视剧
情妇 第二季	电视剧
沸腾冰点	电视剧
清秀佳人	电影&电视剧
ワンワン三銃士	电视剧
Dogtanian and the Three Muskehounds	电视剧
宝贝父女兵	电视剧
弗尔蒂旅馆	电视剧
迷幻特警	电视剧
夜晚园	电视剧
宝家卫国	电视剧
冤家搭档	电视剧
金牌师爷	电视剧
凡间新仙人	电视剧
十三鞭	电视剧
恐龙王国历险记	电视剧
三人行	电影&电视剧
法庭俏佳人	电视剧
小飞侠前传之梦幻历险(港)	电视剧
星闪闪	电影&电视剧
永恒岛	电视剧
邮递员派克叔叔	电影
Postman Pat and His Black and White Cat	电影
大魔法师	电视剧
乔纳森·斯特兰奇与诺瑞尔先生	电视剧
美丽线条	电视剧
欢乐满屋	电视剧
魔幻之旅 第三季	电视剧
神奇动物管理员	电视剧
橘子红了	电视剧
深红与白色的花瓣	电视剧
红玫瑰白玫瑰	电影&电视剧
世纪攻略	电视剧
西蒙的淘氣貓: 餓貓耍主人	电视剧
西蒙的猫	电视剧
羚羊号历险记	电视剧
镜中人	电影&电视剧
归乡	电影
美丽家庭	电视剧
人心	电影
结婚 单身 其他	电视剧
城市双雄	电视剧
叛逆战队	电视剧
白玫瑰皇后	电视剧
白皇后	电视剧
中间人	电影&电视剧
我来也	电影&电视剧
怪探德克	电视剧
鳏夫	电影&电视剧
扫冰者	电视剧
流金税月	电视剧
憨豆先生动画版	电视剧
憨豆先生动画系列	电视剧
出路	电影&电视剧
天蝎行动	电视剧
新好男人	电影&电视剧
亡者之界	电视剧
阴差阳错	电影&电视剧
神奇老太太	电视剧
错爱今生	电视剧
仙剑奇侠传3	电视剧
四个好涩的男人	电影
窥男志	电视剧
财星高照	电影&电视剧
戲仿人生(台)	电视剧
东游记	电影&电视剧
终极特警	电影&电视剧
极限武力没找到
陌生人	电影&电视剧
爱丽丝梦游仙境	电影
新卫斯理传奇	电视剧
急救警情	电视剧
生命火花	电视剧
塞外奇侠	电视剧
缘来是你	电影&电视剧
阎罗传奇	电视剧
金枕头	电视剧
布兰丁斯城堡	电视剧
飞龙五将	电视剧
地下猎人	电视剧
何者永存	电视剧
缘尽今生	电影&电视剧
与海怪同行	电影&电视剧
白蛇后传之人间有爱	电视剧
彪悍人生 第三季	电视剧
绝代双雄	电视剧
星际大奇航	电影&电视剧
叱咤风云	电影&电视剧
临时空缺	电视剧
惊天大阴谋	电影&电视剧
再战封神榜	电视剧
勇者无惧	电影&电视剧
我的一家人	电视剧
人海孤鸿	电影&电视剧
法网情天	电视剧
列队尽头	电视剧
一战往事	电视剧
金色珊顿道	电视剧
双天至尊	电视剧
烈焰焚情	电视剧
生活歌手	电视剧
霹雳红唇	电视剧
鸟歌	电视剧
啭鸣	电视剧
烈血青春	电视剧
孤星血泪	电影&电视剧
最后的王国	电视剧
三面夏娃	电影&电视剧
生命街车	电视剧
你，我与世界末日	电视剧
最后一个大侠	电视剧
Jim Henson's The Storyteller	电视剧
吉姆·汉森的说书人	电视剧
奇缘	电影
出人头地	电影&电视剧
调色板	电视剧
天涯同命鸟	电视剧
Blackadder 2	电视剧
脱罪大师	电视剧
轻舔丝绒	电视剧
轻击天鹅绒	电视剧
玛奇的故事	电视剧
铐	电视剧
仇云盖堡	电视剧
三脚树时代	电影
女巫	电影&电视剧
魔女	电影
屏息	电影&电视剧
医界狂人(台)	电视剧
百慕大之夜	电视剧
回应吧1997	电视剧
Reply 1997	电视剧
Healer	电影&电视剧
捕鼠器里的奶酪	电视剧
Cheese In The Trap	电视剧
又 吴海英	电视剧
Oh Hae-Young Again	电视剧
失踪的黑色M	电视剧
再见，我珍贵的爱	电视剧
Please Come Back Mister	电视剧
秘爱	电影&电视剧
Secret Love Affair	电视剧
Queen and I	电视剧
回应吧1994	电视剧
Reply 1994	电视剧
不可阻挡的High Kick!	电视剧
无法阻挡的High Kick!	电视剧
从星星来的你	电视剧
来自星星的男人	电视剧
她曾漂亮	电视剧
她曾美丽	电视剧
It's Okay It's Love	电视剧
搞笑一家人 第三部	电视剧
噩梦先生	电视剧
拥抱太阳的月亮(港)	电视剧
捧日之月	电视剧
Who Are You－学校2015	电视剧
制作人那些事	电视剧
Oh 我的鬼神君	电视剧
Oh 我的女鬼大人	电视剧
欲戴王冠，必承其重－继承者们	电视剧
The Heirs	电影&电视剧
我的天啊	电视剧
Oh My Venus	电视剧
臭屁虫	电视剧
Larva Season 1	电视剧
坏小子们	电视剧
Bad Guys	电影&电视剧
Wanted没找到
爱情的发现	电视剧
Discovery of Romance	电视剧
Secret Garden	电视剧
Lucky Romance	电视剧
为纯情着迷	电视剧
Falling for Innocence	电视剧
Six Flying Dragons	电视剧
Full House	电影
The Master's Sun	电视剧
38社机动队	电视剧
Tax Team 38	电视剧
Banana Actually	电视剧
十级重案2(港)	电视剧
十级重案(港)	电视剧
特殊案件专门小组	电视剧
吸血鬼儒生	电视剧
龙臂	电视剧
Phantom	电视剧
I Remember You	电影&电视剧
一支梅	电视剧
Iljimae	电视剧
I Need Romance 3	电视剧
用餐吧	电视剧
Let's Eat	电影&电视剧
Sorry, I love you	电视剧
对不起我爱你	电影&电视剧
成均馆罗曼史	电视剧
成均馆儒生的日夜	电视剧
Beautiful Mind	电视剧
닥터 프랑켄슈타인	电视剧
Worlds Within......	电视剧
想念你	电视剧
思念	电影&电视剧
Missing You	电影
Secret Love	电影&电视剧
咖啡王子一号店	电视剧
Coffee Prince 1st Shop	电视剧
Remember – War of the Son	电视剧
最高爱情	电视剧
Top Love	电视剧
你们已经被包围了	电视剧
You're All Surrounded	电视剧
我每天都偷看他	电视剧
Yiootjib Kkotminam	电视剧
华丽的对决(台)	电视剧
我爱张宝利	电视剧
臭屁虫2	电视剧
Larva Season 2	电视剧
应急男女	电视剧
五月的庭院没找到
Goodbye Mr. Black	电视剧
韩版偷偷爱着你	电视剧
韩版花样少年少女	电视剧
两星期	电视剧
Two Weeks	电影&电视剧
一起吃饭吧2	电视剧
你迷上我	电视剧
着迷	电影&电视剧
搞笑一家人2	电视剧
甲洞	电影&电视剧
Gap Dong	电视剧
家族的荣誉	电影&电视剧
家门的荣誉	电视剧
家族荣誉	电影&电视剧
大扑	电视剧
大朴	电视剧
Pasta	电影&电视剧
情侣没找到
The Lover	电影
阿娘	电影&电视剧
Blood没找到
花斗	电视剧
화투	电视剧
亲爱的恩东	电视剧
亲爱的银东啊	电视剧
根深蒂固的树	电视剧
Tree with Deep Roots	电视剧
小区英雄	电视剧
洞内的英雄	电视剧
I Need Romance没找到
Jang Ok-jeong Lives in Love	电视剧
馒头老师和棒棒糖	电视剧
饼干老师与星星糖	电视剧
人生是美丽的没找到
Exgirl Club	电视剧
我可能不会爱你 韩国版	电视剧
너를 사랑한 시간, 7000일	电视剧
总理在恋爱	电视剧
总理恋爱中	电视剧
The Devil没找到
The Flying Superboard	电视剧
新编西游记	电视剧
Coma	电影
Incarnation of Money	电视剧
Damo	电视剧
The Undercover Lady Detective	电视剧
五根手指	电视剧
钢琴森林	电影&电视剧
大明星	电影
那年冬天，起风了	电视剧
That Winter, the Wind Blows	电视剧
Lovers' Rain	电视剧
My Princess	电视剧
说谎给我看看	电视剧
甜蜜绯闻	电视剧
嫂嫂十九岁	电视剧
嫦娥	电影&电视剧
Fly Again	电视剧
Take Care Of Us, Captain	电视剧
风之画师(台)	电视剧
风之花园	电视剧
Tomato没找到
最后的女秘书	电视剧
守护老板	电视剧
秘密男女传	电视剧
Dae Jang-geum	电视剧
A Jewel in the Palace	电视剧
百分之一的可能性	电视剧
再一次 Happy Ending	电视剧
玛丽，外宿中	电视剧
Mary Stayed Out All Night	电视剧
向日葵	电影&电视剧
迹象	电影&电视剧
Sign没找到
Birth of a Beauty	电视剧
Sachoongi Medeulli	电视剧
安托万老板娘	电视剧
Madame Antoine	电视剧
兄妹契约	电视剧
My Girl没找到
重返巴黎	电视剧
Lover in Paris	电视剧
新娘18岁	电视剧
朗朗十八岁	电视剧
Love Witch	电视剧
是美男啊	电视剧
特殊传染病	电视剧
The Virus没找到
玻璃鞋，灰姑娘	电视剧
Glass Shoes	电视剧
蓝色生死恋2：冬日恋歌	电视剧
冬日恋曲	电影&电视剧
天堂的阶梯	电影&电视剧
新进社员	电视剧
Super Rookie	电视剧
吴达子的春天	电视剧
Dal Ja's Spring	电视剧
My Delightful Girl, Choon-Hyang	电视剧
Sassy Girl, Chun-hyang	电视剧
The Idle Mermaid	电视剧
玉林成长日记2	电视剧
Sharp 2	电视剧
看我吧，贵顺	电视剧
Dating Agency: Cyrano	电视剧
丑男大翻身	电影&电视剧
朋友	电影
夜王	电视剧
Queen of Ambition	电视剧
京城绯闻	电视剧
Paradise Ranch	电视剧
九尾狐	电影&电视剧
九尾狐的复仇没找到
朝鲜枪手	电视剧
The Joseon Gunman	电视剧
白痴王子	电视剧
Funny Princes	电视剧
改邪归正	电视剧
Guardian Angel	电影&电视剧
Just Love	电视剧
考试之神	电视剧
个人的取向	电视剧
个人爱好	电视剧
我们能结婚吗	电视剧
Can We Get Married?没找到
Trot Lovers	电视剧
辛德瑞拉姐姐	电视剧
First Love of a Royal Prince	电视剧
A Prince's First Love没找到
红与黑	电影&电视剧
Bad Guy	电影
模特	电影
Model没找到
花样爷爷侦查队	电视剧
希腊封神榜没找到
对与决	电视剧
世界独一无二的善良男人	电视剧
世上哪里都找不到的善良男人	电视剧
面包大王	电视剧
第二次20岁	电视剧
我们的天国	电视剧
Fengsy	电视剧
Beautiful Spy	电视剧
Spy Myeong-Wol	电视剧
错爱	电影&电视剧
Lady Castle	电视剧
My Fair Lady没找到
现代农夫	电视剧
Modern Farmer	电视剧
英雄	电影&电视剧
最佳李顺新	电视剧
最棒李顺心	电视剧
Hwang Jin Yi	电视剧
真情赌注	电视剧
真爱赌注	电视剧
大赌注	电影
粉红色唇膏	电视剧
心情好又温暖	电视剧
橘皮马末兰果酱	电视剧
Orange Marmalade	电视剧
泪之女王	电视剧
贤内助女王2	电视剧
开朗医师奉达熙	电视剧
Surgeon Bong Dal-hee	电视剧
Yellow Handkerchief	电影&电视剧
Will it snow for Christmas?	电视剧
魔女游戏	电影&电视剧
魔女由熙	电视剧
魔女幼熙没找到
钢琴别恋	电影&电视剧
放送人生	电视剧
在空中	电影&电视剧
直到世界尽头	电影
天涯海角	电影&电视剧
顺风产妇人科	电视剧
Soonpoong Clinic	电视剧
宫S	电视剧
百合是趋势	电视剧
Lily Fever	电视剧
Thanks没找到
天使的眼睛没找到
Angel Eyes	电影&电视剧
每当夜晚来临	电视剧
Miss Korea	电视剧
Snow Queen	电影&电视剧
家人之间为何这样	电视剧
What's With This Family	电视剧
罗曼史	电影&电视剧
澡堂老板家的男人	电视剧
洗澡堂老板家男人	电视剧
12年后的重逢：山蒜酱汤	电视剧
Wild Chives and Soy Bean Soup: 12 Years Reunion	电视剧
I jukilnomui sarang	电视剧
Endless Love	电影&电视剧
Padam Padam	电视剧
吧嗒吧嗒	电视剧
蓝色生死恋3：夏日香气	电视剧
Endless Love: Summer Scent	电视剧
茶煲阿四	电视剧
幻想情侣	电视剧
Marriage Not Dating	电视剧
屋塔房小猫	电视剧
屋塔房上的小猫	电视剧
海神	电影&电视剧
Poseidon	电视剧
射向星星	电视剧
大老婆的反击(台)	电视剧
好老婆大联盟	电视剧
只有你	电影&电视剧
Only You	电影&电视剧
淘气少女求爱记	电影&电视剧
Success Story of a Bright Girl	电视剧
My Love Patzzi	电视剧
20岁	电视剧
Twenty Years Old没找到
马铃薯星2013QR3	电视剧
长得像地瓜一样的土豆星球2013QR3	电视剧
阁楼王子	电视剧
屋塔房的王世子	电视剧
Beautiful Man	电视剧
星星在我心	电视剧
Byeoleun nae gaseume	电视剧
i love you没找到
Temptation of an Angel	电视剧
黑道奶爸	电视剧
夏日	电影&电视剧
四姐妹的故事	电影&电视剧
能否听见我心	电视剧
Can You Hear My Heart?没找到
坚强吧，金顺	电视剧
Be Strong Geum Soon	电视剧
Hotel King	电视剧
感觉男女	电视剧
看到味道的少女	电视剧
黄金时间	电影&电视剧
上帝的礼物-14日	电视剧
God's Gift: 14 Days	电视剧
星梦高飞2	电视剧
Dream High 2	电视剧
兄妹情深(台)	电视剧
Giant没找到
太阳吞没	电视剧
女主播的故事	电视剧
期待约会	电视剧
Looking Forward to Romance	电视剧
When a Man Loves	电影
哈佛爱情故事没找到
Love Story in Harvard	电视剧
还想结婚的女人	电视剧
我的野蛮王妃没找到
Princess Hours	电视剧
完美的邻居	电视剧
浪漫艳遇	电视剧
The Chaser	电影&电视剧
现在开始振作起来	电视剧
现在开始Cheer Up	电视剧
我的狐仙女友没找到
我的女朋友是九尾狐	电视剧
刘娜的距离	电视剧
Yoo-Na's Street	电视剧
High Society	电影&电视剧
Heard It Through the Grapevine	电视剧
淘气之吻	电视剧
韩版恶作剧之吻	电视剧
Smile Again	电影&电视剧
Heartless City	电视剧
绅士的风度	电视剧
布拉格之恋	电影&电视剧
Lovers in Prague	电视剧
你好，小姐	电视剧
你好小姐	电视剧
IRIS特务情人	电视剧
妈妈呀姐姐呀	电视剧
My Sweetheart, My Darling没找到
漂亮宝贝	电影&电视剧
神医	电影
时尚之王	电视剧
Fashion King	电视剧
令人垂涎之岛	电视剧
渴望的岛	电视剧
葡萄园里的小伙儿	电视剧
Mask 2015	电视剧
伊甸园之东	电影&电视剧
퐁당퐁당LOVE	电视剧
Bride of the Century	电视剧
生命花	电视剧
命运一样爱着你	电视剧
一夜回忆	电视剧
对我而言可爱的她	电视剧
可爱的她	电视剧
焰火	电影&电视剧
High School - Love On	电视剧
City Hunter	电影&电视剧
三天	电影
Heart To Heart没找到
韩版花样男子	电视剧
韩版流星花园	电视剧
朝鲜三剑客	电视剧
The Three Musketeers	电影
时空侠医	电视剧
타임슬립 닥터진	电视剧
能见到鬼的刑警处容	电视剧
刑警处荣	电视剧
公主	电影
Lovers	电影
我的名字叫金三顺	电视剧
My Name Is Kim Sam-sun	电视剧
传说中的七公主	电视剧
家有七公主	电视剧
村庄：小荷塘的祕密	电视剧
村庄：Atiara的秘密	电视剧
Rainbow Romance	电视剧
旧家义书	电视剧
旧家医书	电视剧
삼대째 국수집(原定名)	电视剧
三代面店	电视剧
甜蜜人生	电影&电视剧
Love Letter	电影
星梦高飞	电视剧
梦想高飞	电视剧
49 Days	电影&电视剧
请和我跳最后一支舞	电视剧
最后的舞请与我一起没找到
请跟我跳最后一支舞没找到
朋友,我们的传说	电视剧
Angry Mom	电视剧
Operation Proposal	电视剧
我心荡漾	电视剧
Goddess of Marriage	电视剧
N no tameni	电视剧
For N	电视剧
小海女	电视剧
海女小天	电视剧
Suika	电视剧
Tokyo Love Story	电视剧
家庭的模样	电视剧
Family's Form	电视剧
朝5晚9：帅气和尚恋上我	电视剧
朝五晚九：俊俏和尚爱上我	电视剧
HOPE～不受期待的新人～	电视剧
HOPE～期待度零的新进员工～	电视剧
约会：恋爱为何物	电视剧
Deto - Koi to wa Donna Mono Kashira	电视剧
轻松爱你	电视剧
我家啥都没有	电视剧
Byakuyakou	电视剧
白夜行	电影&电视剧
失恋的巧克力职人	电视剧
失恋朱古力(港)	电视剧
有问题的餐厅	电视剧
A Restaurant with Many Problems	电视剧
请与废柴的我谈恋爱	电视剧
拜托请爱我	电视剧
99.9：刑事专门律师	电视剧
Shiroi Kyotou	电视剧
The Ivory Tower	电视剧
真田丸	电视剧
Gomenne Seishun	电视剧
Regret From My School Life	电视剧
长假	电影&电视剧
Long Vacation	电影&电视剧
东大特训班	电视剧
Dragon Sakura	电视剧
Yonimo kimyô na monogatari	电视剧
大川端探侦社	电视剧
River's Edge Ookawabata Tanteisha	电视剧
直美和加奈子	电视剧
豆豆电视	电视剧
点心之家	电视剧
糖果之家	电视剧
GU·RA·ME～总理的料理人～	电视剧
Yûbe no Curry, Ashita no Pan	电视剧
Last Night's Curry, Tomorrow's Bread	电视剧
倒数第二次之恋	电视剧
Saigo Kara Nibanme no Koi	电视剧
Last Friends	电视剧
Rasuto furenzu	电视剧
死亡纸币	电视剧
Death Cash	电视剧
硝子之苇	电视剧
garasu no ashi	电视剧
Tiger & Dragon没找到
熟男不结婚	电视剧
Kekkon Dekinai Otoko	电视剧
Osen	电影&电视剧
Nodame Cantabile	电影&电视剧
Pan to Soup to Nekobiyori	电视剧
Bread and Soup and Cat Weather	电视剧
Kodoku no Gurume 4	电视剧
Solitary Gourmet 4	电视剧
Puropôzu dai sakusen	电视剧
Operation Love	电视剧
一吻定情2013东京版	电视剧
恶作剧之吻之爱在东京	电视剧
淘气小亲亲	电视剧
流星的羁绊	电视剧
Ryusei no kizuna	电视剧
Shinya Shokudo 2	电视剧
Tamio	电视剧
Tamiou	电视剧
民王	电视剧
黑金丑嶋君	电视剧
吸血大耳窿	电视剧
Dr. Rintaro	电视剧
无间双龙：爱的正义战士	电视剧
Ouroboros: Konoaikoso, Seigi	电视剧
Shinya Shokudo 3	电视剧
返乡	电影
老板	电影
妙手仁医	电影&电视剧
富贵男贫穷女	电视剧
多金社长小资女(台)	电视剧
Jo'ô no kyôshitsu	电视剧
The Queen's Classroom	电视剧
一触即落	电视剧
旋爱	电视剧
ラブ シャッフル	电视剧
欺诈游戏	电视剧
说谎者的游戏	电视剧
Kyou wa Kaisha Yasumimasu	电视剧
料亭小師傅	电视剧
Haikei, Chichiue-sama	电视剧
BORDER 警視庁捜査一課殺人犯捜査第4係	电视剧
灵异界限(台)	电视剧
BORDER	电视剧
Never Let Me Go	电视剧
Atsuhime	电视剧
侦探伽利略	电视剧
伽利略	电影&电视剧
11 nin mo iru!	电视剧
亲爱的姐妹	电视剧
我妹是恶魔(台)	电视剧
来自北国	电视剧
Love Generation	电影&电视剧
天皇御厨(台)	电视剧
天皇的料理人	电视剧
Nobunaga Concerto	电视剧
星星之火	电影&电视剧
火之粉	电影&电视剧
倒数第二次恋爱2	电视剧
倒数第二次恋爱 续篇	电视剧
在世界的中心呼喊爱	电视剧
Sekai no chûshin de, ai wo sakebu	电视剧
伪装的夫妇	电视剧
假扮夫妻	电视剧
妈妈明天不在	电视剧
Ashita, Mama ga Inai	电视剧
影子写手	电影&电视剧
Ghost Writer	电影&电视剧
TV版没找到
Wonderful Single Life没找到
Gochisousan	电视剧
Thank You For The Meal没找到
Keizoku	电视剧
花癡刑警	电视剧
自戀刑警	电视剧
某天想起这段恋情一定会哭泣	电视剧
回忆起这段恋情一定会哭吧	电视剧
脑侦探	电视剧
Wagaya no rekishi	电视剧
Happy Marriage	电影&电视剧
父女变变变(台)	电视剧
父女七日换	电视剧
Trick没找到
Pride没找到
冰上悍将(台)	电视剧
美女沒人爱	电视剧
Watashi ga Ren'ai Dekinai Riyû	电视剧
Garireo Season 2	电视剧
世上最难恋爱	电视剧
世界第一难的恋爱	电视剧
SPEC 警视厅公安部公安第五课 未详事件特别对策系事件簿	电视剧
超能力事件簿	电视剧
拥有神之舌的男人	电视剧
干物女	电视剧
Hotaru no hikari	电影&电视剧
一吻定情之爱在东京2	电视剧
恶作剧之吻之爱在东京2	电视剧
人间失格-假如我死的话	电视剧
Ningen Shikkaku: Tatoeba bokuga shindara	电视剧
打工族买房记	电视剧
打工仔买房记	电视剧
hard to say I love you	电视剧
无法坦诚	电视剧
怪盗侦探山猫	电视剧
The Mysterious Thief Yamaneko	电视剧
Ikebukuro West Gate park	电视剧
改造野猪妹	电视剧
Nobuta wo produce	电视剧
勇士闯魔城	电视剧
勇士吉彦与魔王之城	电视剧
不需要爱情的夏天	电影&电视剧
夏天，不需要爱情	电视剧
ヒーロー没找到
Hero	电影
猫武士	电视剧
Nekozamurai Season 1	电视剧
金牌没找到
金牌妈妈	电视剧
女教父	电视剧
Gokusen	电视剧
我们都是超能力者	电视剧
Minna! ESPer Dayo!	电视剧
Seijo	电视剧
Saintess	电视剧
一公升的眼泪	电影&电视剧
Ichi rittoru no namida	电视剧
1 Litre of Tears	电影
五个同名女子	电视剧
温柔时间	电视剧
Yasashii Jikan	电视剧
明天也一定会和你恋爱	电视剧
干物女2	电视剧
Hotaru no hikari 2	电视剧
Manhattan rabu stôrî	电视剧
Manhattan Love Story	电影
Atami no Sosakan	电视剧
Flowers for Algernon	电影&电视剧
Nazotoki wa Dinner no Ato de	电视剧
Kodokunogurume Season 3	电视剧
沉睡森林	电视剧
A Sleeping Forest	电视剧
铁甲小宝—卡布达	电视剧
同食共寝住一起	电视剧
Kuu Neru Futari Sumu Futari	电视剧
Furuhata Ninzaburo	电视剧
Kounodori	电视剧
勇敢活下去	电视剧
尽管如此也要活下去	电视剧
Keibuho Furuhata Ninzaburo	电视剧
Forbidden Love	电影&电视剧
Majo no joken	电视剧
非常保姆	电视剧
Kaseifu no mita	电视剧
Last Cinderella	电视剧
オンナを忘れた女が、しあわせを探す物語	电视剧
Long Love Letter～Hyoryu Kyoshitsu	电视剧
Rongu rabu retâ: Hyôryû kyôshitsu	电视剧
Wakamono Tachi	电视剧
The Higashino Keigo Mysteries	电视剧
Yamikin Ushijima-kun Season 2	电视剧
Penance	电影&电视剧
Shokuzai	电视剧
梦想起飞	电影&电视剧
梦想飞行	电视剧
希	电视剧
Mare	电视剧
小秘书贝原和6位有病的客人	电视剧
秘书贝原和6个可疑访问者	电视剧
JOKER ジョーカー許されざる捜査官	电视剧
Joker	电影
浮华世家	电视剧
华丽家族	电影&电视剧
The Family没找到
百鬼夜行抄	电视剧
时尚恶魔(台)	电视剧
Suzuki Sensei	电视剧
マイボス、マイヒーロー	电视剧
Mai bosu, Mai hîrô	电视剧
My Boss, My Hero没找到
code blue	电视剧
ロクヨン	电视剧
裸夏	电影&电视剧
夏裸	电视剧
SUMMER NUDE	电视剧
Onna Kudoki Meshi	电视剧
Liar Game 2	电视剧
Siren	电影&电视剧
想吃什锦面	电视剧
Chanpon Tabe Taka	电视剧
那些日子以来	电影&电视剧
Boku no Ita Jikan	电视剧
The Hours Of My Life没找到
悦声响起	电视剧
情歌没找到
Love Song	电影
恭候大驾阴阳屋	电视剧
欢迎来到万事占卜阴阳屋	电视剧
Second Love	电影&电视剧
超人迪加	电视剧
迪迦·奥特曼	电视剧
没有玫瑰的花屋	电视剧
没有蔷薇的花店	电视剧
全开girl	电视剧
Bloody Monday	电视剧
Beginner	电视剧
Jikô keisatsu	电视剧
Miseinen	电视剧
未成年	电影&电视剧
我来接您了	电视剧
大和拜金女	电视剧
恐怖的夏夜	电视剧
Kageri Yuku Natsu	电视剧
刑警七人	电视剧
Enka: Gold Rush	电视剧
爱丽丝的荆棘没找到
Alisu no Toge	电视剧
爱的病理	电视剧
Kazokugari	电视剧
同龄翁婿	电视剧
喊声岳父不容易	电视剧
家的记忆(台)	电视剧
记忆消减没找到
Yokoku Han: The Pain	电视剧
勇士闯魔城2	电视剧
姐姐	电影&电视剧
anegoアネゴ-	电视剧
成熟女子	电视剧
大人女子	电视剧
尼采大师	电视剧
Gokusen 2	电视剧
年龄欺凌	电视剧
Age Harassment	电视剧
33分侦探	电视剧
33 pun tantei	电视剧
聖者の行進	电视剧
Bitter Blood	电影&电视剧
无名之毒	电视剧
Namonaki Doku	电视剧
Iryû: Team Medical Dragon	电视剧
给梦的女孩	电视剧
最后的警察 第一季	电视剧
接吻狂魔	电视剧
坂本龙马传	电视剧
Ryomaden	电视剧
Don Quixote	电影
砂器	电影&电视剧
彼得的送葬队	电视剧
彼得的葬列	电视剧
Zettai kareshi	电视剧
Absolute Boyfriend	电视剧
Kemonomichi	电视剧
Trick 2	电视剧
越狱兔第0季	电视剧
Usavich Zero	电视剧
Prison School	电视剧
恶德侦探制裁社	电视剧
Tantei no Tantei	电视剧
不公平没找到
Hanako to Anne	电视剧
Hanako and Anne	电视剧
糸子的洋裝店(台)	电视剧
Carnation	电视剧
永远的仔	电视剧
永远是孩子	电视剧
The Queen of Lunchtime Cuisine	电视剧
Ranchi no joô	电视剧
废柴高中生的蜕变	电视剧
等你说爱我	电影&电视剧
Trick3	电视剧
TRICK -Troisième partie-	电视剧
书架食堂2	电视剧
本棚食堂	电视剧
我的怪同学	电视剧
上课小动作	电视剧
幸运之七人	电视剧
Lucky Seven	电影&电视剧
亲密搭档	电视剧
无敌律师	电视剧
梦想加洲	电视剧
十七岁	电影
Saibancho! Onaka Sukimashita!	电视剧
不便的便利店	电视剧
要在蒂凡尼吃早餐	电视剧
迟早能到蒂凡尼吃早餐	电视剧
战斗吧！书店少女	电视剧
Tenchijin	电视剧
天地人	电视剧
Limit没找到
獸醫杜立德	电视剧
My Dandyism	电视剧
神秘妻子	电视剧
まるまるつま	电视剧
病理医生	电视剧
脆弱	电影&电视剧
Fragile	电影
Yoshitsune	电视剧
相棒1	电视剧
牙刷	电视剧
女友们	电影&电视剧
Dekichatta kekkon	电视剧
教头当家	电视剧
不良學園(台)	电视剧
千面女郎	电影&电视剧
Glass Mask	电视剧
深夜的面包店	电视剧
幸福送行者	电视剧
新丁礼仪师	电视剧
Tairano Kiyomori	电视剧
不屈的女人没找到
小孤岛大医生	电视剧
离岛大夫日志没找到
Yûkan kurabu	电视剧
こいびとよ	电视剧
Aibou	电视剧
Voice没找到
交涉人	电影&电视剧
讲数阿姐(港)	电视剧
A Wednesday love affair没找到
Suiyobi no joji	电视剧
Psycho Doctor	电视剧
心理医生恭介	电视剧
Yaoh	电视剧
没有家的女孩	电视剧
Detective Conan	电影
彩虹色的夏日之恋	电视剧
Romance In Summer Rainbow	电视剧
猫咪の食堂	电视剧
理想的结婚	电视剧
Gunshi Kanbee	电视剧
Strategist Kanbe	电视剧
四月一日灵异记事簿真人版	电视剧
不忠时刻	电视剧
不信时刻	电视剧
谈判专家	电影&电视剧
Bussen	电影&电视剧
OL日本	电视剧
Lady Joker	电影&电视剧
相棒 第七季	电视剧
不愉快的基因没找到
争产家族	电视剧
全白	电视剧
欢喜冤家	电影&电视剧
Friends没找到
画江湖之不良人	电视剧
危ない放課後	电视剧
少年事件薄没找到
老公当家	电视剧
出嫁没找到
Erai tokoroni totsuide shimatta	电视剧
华丽间谍没找到
Death Game Park没找到
雷欧·奥特曼	电视剧
Ultraman Reo	电视剧
天使的刀	电视剧
Mosaic Japan	电视剧
外事警察	电视剧
地狱少女真人版没找到
じごくしょうじょ	电视剧
歌哥	电视剧
秘密花園	电视剧
秘密的花园	电影&电视剧
马路须加学园	电视剧
Majisuka gakuen	电视剧
Orange Days	电视剧
Kami no Tsuki	电影&电视剧
Paper Moon	电影
A.I.人工智慧男友(台)	电视剧
安堂机器人 ～A.I. knows LOVE?～	电视剧
妖怪人间	电视剧
妖怪人间贝姆	电视剧
活得比你好	电视剧
Nagareboshi	电视剧
即使弱小也能取胜	电视剧
以弱胜强：青志老师和废柴高中球员的野心	电视剧
姻缘猎人	电视剧
Beautiful Life	电影
山田太郎物语	电视剧
八重樱	电视剧
Yae no Sakura	电视剧
川島芳子的一生	电视剧
金璧辉	电视剧
over time	电视剧
LADY 最后的犯罪画像	电视剧
Lady: Saigo no hanzai purofairu	电视剧
为爱逃亡	电视剧
为了心爱的你	电视剧
冰血暴	电影
家庭主妇侦探	电视剧
全职主妇侦探	电视剧
女子别动队	电影&电视剧
玉川区役所 OF THE DEAD	电视剧
蜡笔小王国	电视剧
Crayon Kingdom of Dreams	电视剧
キュート	电视剧
Q10	电视剧
神之雫	电视剧
Kami no shizuku	电视剧
Moon Lovers	电视剧
Tsuki no koibito	电视剧
人生无价(台)	电视剧
有无价的东西才怪	电视剧
红十字：女人们的召集令	电视剧
不该被忘记的他们	电视剧
Kindaichi shônen no jikenbo	电视剧
37.5°C no Namida	电视剧
The 37.5°C Tears	电视剧
Sailor fuku to kikanjuu	电视剧
飞翔公关室	电视剧
冰点	电影&电视剧
一個屋簷下(港)没找到
一个屋檐下	电视剧
硬派医生	电视剧
Bull Doctor	电视剧
东洋特快杀人事件	电视剧
天守物语	电影&电视剧
satorare	电视剧
倾听我心	电视剧
白线流 那些日子以来~25岁	电视剧
Kyandi Kyandi	电视剧
Candy Candy没找到
Oniyome nikki: Ii yu da na	电视剧
吉他盒之女	电视剧
Life	电影
Raifu	电视剧
Tantei gakuen Q	电视剧
Do S Deka	电视剧
Sadistic Detective	电视剧
疫病神シリーズ 螻蛄	电视剧
满清末代王朝(台)	电视剧
For the Sake of the Republic	电视剧
走向共和	电视剧
余罪 第二季	电视剧
我爱我家	电视剧
87版红楼梦	电视剧
央视版红楼梦	电视剧
A Dream in Red Mansions	电影
红楼梦	电影&电视剧
Rakshasa Street	电视剧
镇魂街	电影&电视剧
Unforgiven没找到
The Legend of LUOXIAOHEI	电视剧
罗小黑战记	电视剧
劣质好先生	电视剧
幸福有多远	电影&电视剧
Soldiers Sortie	电视剧
士兵突击	电视剧
My Own Swordsman	电视剧
Scarlet Heart	电视剧
Startling by Each Step	电视剧
Wuxin: The Monster Killer	电视剧
Battle of Changsha	电视剧
战长沙	电视剧
Swords of Legends	电视剧
古剑奇谭	电视剧
All Quiet in Peking	电视剧
北平无战事	电视剧
Legend of Fragrance	电视剧
康熙帝国	电视剧
康熙大帝	电视剧
Judge of Song Dynasty	电视剧
大宋提刑官	电视剧
杉杉来吃	电影&电视剧
杉杉的美味爱情	电视剧
长歌行	电视剧
Singing All Along	电视剧
The Romance of Three Kingdoms	电视剧
The Grand Mansion Gate	电视剧
大宅门	电影&电视剧
Palace of Desire	电视剧
大明宫词	电视剧
Edge City Wanderer	电视剧
潜伏	电影&电视剧
异人没找到
the outcast没找到
谜杀	电视剧
迷砂	电视剧
苍穹の昴	电视剧
The Firmament Of The Pleiades	电视剧
苍穹之昴	电视剧
女王乔安	电视剧
Moral Peanuts	电视剧
毛骗 第一季	电视剧
旋风少女 第二季	电视剧
新大秦帝国(台)	电视剧
大秦帝国：裂变	电视剧
大秦帝国之裂变	电视剧
The Ordinary World	电视剧
长相依	电视剧
Chronicle of Life	电视剧
大秦帝国2：纵横	电视剧
大秦帝国2	电视剧
大秦帝国之纵横	电视剧
Drawing Sword	电视剧
亮剑	电影&电视剧
Evil Minds	电视剧
围城	电影&电视剧
我的团长我的团	电视剧
匆匆那年网络剧	电视剧
Back in Time	电视剧
My Amazing Boyfriend没找到
新版红楼梦	电视剧
The Dream of Red Mansions	电影&电视剧
Stories of an Editorial Board	电视剧
编辑部的故事	电视剧
仁显王后的男人中国版	电视剧
爱在公元前	电视剧
Go Princess Go	电视剧
Legend of Miyue	电视剧
Chinese Paladin	电视剧
The Stand-In	电视剧
My Sunshine	电影&电视剧
毛骗 终结篇	电视剧
Who Sleeps My Bro	电影&电视剧
小李飞刀	电影&电视剧
仙侠奇缘之花千骨	电视剧
The Journey of Flower	电视剧
舒克与贝塔	电影&电视剧
舒克和贝塔	电影&电视剧
Mr. Bodyguard 2	电视剧
The Story of a Noble Family	电视剧
金粉世家	电影&电视剧
铁齿铜牙纪晓岚 第一部	电视剧
铁齿铜牙纪晓岚	电视剧
贞观之治	电视剧
少年包青天 第一部	电视剧
少年包青天	电视剧
新烟雨濛濛	电视剧
情深深雨蒙蒙	电视剧
情深深雨濛濛	电视剧
新三国演义	电视剧
Three Kingdoms	电视剧
三国	电视剧
Haier Brothers	电视剧
海尔兄弟	电视剧
致我们终将逝去的青春	电影&电视剧
So Young	电影&电视剧
人间正道是沧桑	电视剧
玉观音	电影&电视剧
魔方大厦	电视剧
邋遢大王奇遇记	电影&电视剧
死亡通知单	电影&电视剧
Death Notify	电视剧
暗黑者	电影&电视剧
고품격 짝사랑	电视剧
High End Crush	电视剧
高品格单恋	电视剧
勇者大冒险  第二季	电视剧
葫芦娃	电影&电视剧
葫芦兄弟	电影&电视剧
旋风百草	电视剧
Whirlwind Girl	电视剧
旋风少女 第一季	电视剧
Love Story in Shanghai	电视剧
Symphony of Rain	电视剧
像雾像雨又像风	电视剧
Romance of Our Parents	电视剧
报告老板 第二季! 权力游戏	电视剧
Yes Boss	电视剧
报告老板 第二季	电视剧
重案六组 第一部	电视剧
重案六组	电视剧
Love Me, If You Dare	电视剧
他来了，请闭眼	电影&电视剧
狐妖小红娘	电影&电视剧
Decoded	电视剧
青春女保镖	电视剧
茶馆	电影&电视剧
似水年华	电影&电视剧
Legend of SouthWest Dance and Music	电视剧
舞乐传奇	电视剧
A Native of Beijing in New York	电视剧
北京人在纽约	电视剧
爱情公寓第四季	电视剧
iPartment 4	电视剧
黎明之前	电影&电视剧
Good day in life没找到
暗算之听风	电视剧
无名英雄之暗算	电视剧
暗算	电视剧
见鬼之灵魂摆渡	电视剧
大吉大利	电视剧
灵魂摆渡	电视剧
Monkey King	电影&电视剧
西游记	电影&电视剧
女医·明妃传	电视剧
The Imperial Doctress	电视剧
一地鸡毛	电视剧
千金归来	电视剧
汉武大帝	电视剧
大熔炉	电视剧
天龙八部	电影&电视剧
镜花缘	电视剧
Police Beauty & K9	电视剧
桔子红了	电视剧
水浒传	电影&电视剧
The Vigilantes in Masks	电视剧
怪侠一枝梅	电影&电视剧
Yes Boss!	电视剧
报告老板！ 第一季	电视剧
Grow Up没找到
长大	电影&电视剧
毛骗·贰	电视剧
Moral Peanuts Season 2	电视剧
毛骗 第二季	电视剧
战地三部曲	电视剧
战地1938	电视剧
生死线	电影&电视剧
舞法天女	电视剧
舞法天女朵法拉	电视剧
struggle没找到
奋斗	电影&电视剧
上错花轿嫁对郎	电影&电视剧
北爱	电视剧
BeiJing Love Story	电视剧
北京爱情故事	电影&电视剧
大玉儿	电视剧
孝庄秘史	电视剧
过把瘾	电视剧
武侠张三丰	电视剧
Taiji Prodigy	电视剧
少年张三丰	电视剧
大唐神探狄仁杰	电视剧
武朝迷案	电视剧
神探狄仁杰	电视剧
The Myth	电视剧
神话	电影&电视剧
灵魂摆渡 第二季	电视剧
灵魂摆渡2	电视剧
《画江湖》系列之《灵主》	电视剧
画江湖之灵主	电视剧
云之凡	电视剧
仙剑奇侠传5	电视剧
灵剑山 群星之宴	电视剧
无悔追踪	电视剧
星月传奇	电视剧
大漠谣	电视剧
风中奇缘	电影&电视剧
十二生肖的故事没找到
十二生肖	电影&电视剧
神雕侠侣	电影&电视剧
Divorce Lawyers	电视剧
离婚律师	电视剧
仙狐传奇	电视剧
Legend of Nine Tails Fox	电视剧
家有儿女第二部没找到
家有儿女Ⅱ	电视剧
家有儿女2	电视剧
女相	电视剧
陆贞传奇	电视剧
蜀山剑侠传	电视剧
剑侠传奇	电影
The Legend of Zu	电影
你是我爸爸没找到
嘿，老头！	电视剧
Qiao's Grand Courtyard	电视剧
乔家大院	电视剧
生活之他乡	电视剧
好先生番外篇	电视剧
李卫当官	电视剧
Der Räuber Hotzenplotz	电影&电视剧
大盗贼	电影&电视剧
我的伯父周恩来	电视剧
克拉小姐	电视剧
克拉恋人	电影&电视剧
张学良	电视剧
Young Marshal	电视剧
小虎历险记	电视剧
小虎还乡	电视剧
08版射雕	电视剧
新射雕英雄传	电视剧
射雕英雄传	电影&电视剧
蓝皮鼠和大脸猫 第一部	电视剧
蓝皮鼠和大脸猫	电视剧
Dating Hunter	电视剧
约会专家	电视剧
Imminent Crisis	电视剧
一触即发	电影&电视剧
少年足球	电影&电视剧
东北一家人	电视剧
I'm Looking Forward to Being Loved	电视剧
好想好想谈恋爱	电视剧
秦时明月3	电视剧
秦时明月之诸子百家	电视剧
Empress Wu Mei Niang	电视剧
至尊红颜	电视剧
隋唐演义	电视剧
我们遥远的青春	电视剧
Where is Our Youth Age	电视剧
我们无处安放的青春	电视剧
The Four没找到
哈哈镜花缘	电视剧
One Servant of Two Masters	电视剧
一仆二主	电影&电视剧
男闺蜜	电视剧
Honey Bee Man	电视剧
我爱男闺蜜	电视剧
天下粮田	电视剧
天下粮仓	电视剧
我的朋友陈白露小姐网剧版	电视剧
My Friend Miss Chen Bai Lu	电视剧
Affair of Half a Lifetime	电视剧
半生缘	电影&电视剧
First Love	电影
幸福像花儿一样	电视剧
聊斋1	电视剧
新版聊斋	电视剧
聊斋志异	电影&电视剧
The Magistrate Who's Nine	电视剧
九岁县太爷	电视剧
12.1枪杀大案	电视剧
121枪杀大案	电视剧
12·1枪杀大案	电视剧
偷龙转凤	电影&电视剧
绝色双娇	电视剧
女儿当自强	电影&电视剧
杨门女将之女儿当自强	电影&电视剧
杨门女将	电影&电视剧
The Identity of Father	电视剧
炊事班的故事2	电视剧
欢天喜地七仙女	电视剧
假如爱有天意	电影&电视剧
火红年代	电视剧
The winter solstice	电视剧
冬至	电影&电视剧
暗黑者 第二季	电视剧
Darker 2	电视剧
最佳恋人	电视剧
功夫兔与菜包狗	电视剧
末代皇帝	电影&电视剧
溥仪和他的五个女人	电视剧
非常公民	电视剧
十万个冷笑话 第三季	电视剧
Falling Down Season 2没找到
执念师 第二季	电视剧
我的兄弟叫顺溜	电视剧
Nos Annees Francaises	电视剧
我们的法兰西岁月	电视剧
大耳朵图图	电视剧
炊事班的故事3	电视剧
杜拉拉大结局没找到
杜拉拉	电视剧
我的金婚时代	电视剧
王贵与安娜	电视剧
十万个冷笑话 第二季	电视剧
莲花童子哪吒	电视剧
新昙花梦	电视剧
Epiphyllum Dream	电视剧
烽火佳人	电影&电视剧
聊斋一	电视剧
Strange Tales of Liao Zhai	电视剧
聊斋奇女子	电视剧
孙子兵法与三十六计	电视剧
追鱼	电影&电视剧
追鱼传奇	电视剧
连城诀	电影&电视剧
Marriage Battle	电视剧
婚姻保卫战	电视剧
太阳之子	电影&电视剧
楚汉传奇	电视剧
济公游记	电视剧
可可可心一家人	电视剧
家有九凤	电视剧
Think Before You Marry	电视剧
The Wife's Secret	电视剧
妻子的秘密	电视剧
邓小平	电影&电视剧
성길사한	电视剧
Chingiz Khan	电视剧
成吉思汗	电影&电视剧
三少爷的剑	电影&电视剧
Emergency Room	电影&电视剧
五星饭店	电视剧
五星大饭店	电视剧
The New Woman Son-in-law of the Emperor	电视剧
新女驸马	电视剧
真命小和尚之无字天书	电视剧
真命小和尚	电视剧
PAL INN	电视剧
仙剑客栈 第一季	电视剧
国家安全之于无声处	电视剧
In the Silence没找到
于无声处	电影&电视剧
老炮儿网络剧	电视剧
老炮儿(网络剧)	电视剧
外来媳妇本地郎	电影
五月槐花香	电视剧
阿笨猫	电视剧
四世同堂	电视剧
刑警本色	电影&电视剧
The Legend of the Monster	电视剧
唐人街	电影&电视剧
雷雨	电影&电视剧
动什么，别动感情	电视剧
少年军校	电视剧
少年特工	电视剧
新乱世佳人	电视剧
璀璨人生	电视剧
Detective Tanglang	电视剧
唐琅探案	电视剧
凤穿牡丹	电视剧
两个女人的故事	电影&电视剧
追	电影&电视剧
天下无贼	电影&电视剧
The Bride with White Hair	电影&电视剧
新白发魔女传	电视剧
Miss Puff	电视剧
泡芙小姐第一季	电视剧
真情告白	电影&电视剧
Dandelion	电影&电视剧
蒲公英	电影&电视剧
难得有情人	电影&电视剧
偷渡客	电影&电视剧
危险旅程	电视剧
两个人的战争没找到
红处方	电视剧
官场插班生	电视剧
草民县令	电视剧
秦时明月特别篇之空山鸟语	电视剧
秦时明月空山鸟语特别篇	电视剧
空山鸟语	电影&电视剧
Cell Phone	电影&电视剧
手机	电影&电视剧
熊猫京京	电视剧
金枝玉叶	电影&电视剧
小萝卜头	电影&电视剧
欲望	电影&电视剧
The Big Case on the Mekong River	电视剧
NUAN CHUN	电视剧
暖春	电影&电视剧
为爱放手	电影&电视剧
香港姐妹	电视剧
女人花	电影&电视剧
高纬度战栗	电视剧
甜蜜蜜	电影&电视剧
侠骨丹心	电影&电视剧
武则天秘史	电视剧
大丈夫姊妹篇	电视剧
May-December Love 2	电视剧
Rules Before A Divorce	电视剧
离婚前规则	电视剧
梁山伯与祝英台新传	电影&电视剧
新梁山伯与祝英台	电影&电视剧
Tiger Mom	电视剧
虎妈猫爸	电视剧
新雪豹	电视剧
雪豹坚强岁月	电视剧
King of Lan Ling	电视剧
兰陵王	电影&电视剧
忠诚	电影&电视剧
心网	电视剧
青春出动	电视剧
爱情宝典	电视剧
屌丝	电视剧
Diors Man	电视剧
屌丝男士 第一季	电视剧
恰同学少年	电影&电视剧
两个天堂之还珠格格	电视剧
还珠姬(日)	电视剧
婆婆媳妇小姑	电视剧
铁骑银瓶	电视剧
Crouching Tiger, Hidden Dragon	电影&电视剧
卧虎藏龙	电影&电视剧
我是特种兵3	电视剧
我是特种兵之火凤凰	电视剧
特种兵之火凤凰	电视剧
门·第	电视剧
门第	电视剧
金耳环	电影&电视剧
河流如血	电视剧
隋唐英雄传	电视剧
康熙微服私访记3	电视剧
胜女的时代	电视剧
胜女的春天	电视剧
胜女的代价2	电视剧
水月洞天续集-灵镜传奇	电视剧
灵镜传奇	电视剧
情定三生	电影&电视剧
十二生肖传奇	电视剧
超人马大姐	电视剧
你好，X先生 第二季	电视剧
只为遇见你	电视剧
我和X先生 第二季	电视剧
大唐女巡按	电影&电视剧
围棋少年	电视剧
敌营十八年	电视剧
中国家庭之新渴望	电视剧
浮沉	电影&电视剧
少年包青天2	电视剧
少年包青天Ⅱ	电视剧
小夫妻时代没找到
Dual-core Era	电视剧
双核时代	电视剧
临时家庭	电视剧
乌龙山剿匪记	电视剧
我的野蛮女友	电影&电视剧
一江春水向东流	电影&电视剧
血战到底	电影&电视剧
少林武王	电视剧
齐宣王与钟无艳	电影&电视剧
Unexpectedness	电视剧
万万没想到 第一季	电视剧
缘来一家人	电视剧
水月洞天	电视剧
王中王	电影&电视剧
第三种爱情	电影&电视剧
绝爱	电影&电视剧
大唐情史	电视剧
自古英雄出少年	电影&电视剧
精卫填海	电视剧
大学生同居的事儿 第一季	电视剧
The story of hongmao and lantu	电视剧
虹猫蓝兔七侠传	电视剧
极速的浪漫青春	电视剧
欢喜婆婆俏媳妇	电视剧
小井胡同	电视剧
武林外传动画版	电视剧
浪漫人生	电视剧
Romantic Life	电视剧
血色浪漫	电影&电视剧
和你在一起	电影&电视剧
山楂树之恋	电影&电视剧
飞虎神鹰	电影&电视剧
喜羊羊与灰太狼(第531-590集)	电视剧
喜羊羊与灰太狼之羊羊运动会	电视剧
天师钟馗之美丽传说	电视剧
大厨	电影&电视剧
Diors Man 4	电视剧
屌丝男士 第四季	电视剧
巴哥正传	电视剧
闯关东	电视剧
薛仁贵传奇	电视剧
中国版孤独的美食家	电视剧
孤独的美食家 台湾版	电视剧
孤独的美食家 第一季·台湾篇	电视剧
恋人	电影&电视剧
爸爸我怀了你的孩子	电视剧
Feast没找到
满汉全席没找到
家有儿女第三部没找到
Home With Kids3	电视剧
家有儿女3	电视剧
女人不再沉默	电视剧
大脚马皇后	电视剧
情满珠江	电视剧
谍影重重之上海	电视剧
乱世英雄吕不韦	电视剧
Lv Bu Wei - The Hero In Times Disorder	电视剧
吕不韦传奇	电视剧
辣味英雄传	电视剧
爱情公寓番外篇辣味英雄传 第一季	电视剧
Blazing Teens	电视剧
摇摇新世代	电视剧
火力少年王	电视剧
北漂妈妈	电视剧
你知道我在等你吗	电视剧
等你爱我	电影&电视剧
拍案惊奇	电影&电视剧
Amazing Cases	电视剧
无敌县令	电视剧
杨乃武与小白菜	电影&电视剧
夫妻那些事2	电视剧
We Are Still Married	电视剧
皇家娇医	电视剧
Royal Johnson Medical	电视剧
刁蛮俏御医	电视剧
我的青春我做主	电视剧
我的青春谁做主	电视剧
The Love is Inconceivable	电视剧
爱情最美丽	电视剧
The House of Apple	电视剧
红苹果乐园	电视剧
封神榜	电影&电视剧
One hundred thousand bad jokes	电视剧
十万个冷笑话 第一季	电视剧
报告老板贺岁篇豪言壮旅	电视剧
报告老板之豪言壮旅	电视剧
太平天国	电影&电视剧
人物志水浒传	电视剧
水浒	电视剧
将军	电影
腾空的日子	电视剧
Stealing Hearts	电视剧
天若有情	电影&电视剧
任长霞	电影&电视剧
夏家三千金	电视剧
男自	电视剧
拭血问剑	电视剧
新水浒后传	电视剧
水浒后传	电视剧
让爱做主	电视剧
午夜阳光	电视剧
Hei Mao Jing Zhang	电视剧
黑猫警长	电影&电视剧
新鹿鼎记	电视剧
Royal Tramp	电影&电视剧
十八岁的天空	电影&电视剧
Spell of the Fragrance	电视剧
国色天香	电影&电视剧
Diors Man 2	电视剧
屌丝男士 第二季	电视剧
We Get Married没找到
咱们结婚吧	电影&电视剧
白眉大侠	电视剧
I Have a Date with Spring	电视剧
倚天屠龙记	电影&电视剧
Sword Sabre	电视剧
Forensic Heroes	电视剧
Presumed Accidents	电视剧
Rosy Business II	电视剧
The Menu	电影&电视剧
港版伽利略	电视剧
谈情说爱	电影&电视剧
Blue Veins	电视剧
机灵小和尚没找到
学堂威龙	电视剧
机灵小不懂	电视剧
Brother's Keeper	电影
At the Threshold of an Era	电视剧
Triumph In The Skies	电视剧
Chung seung wan siu	电视剧
Rosy Business	电视剧
妻妾成群	电视剧
超能探长	电视剧
僵尸探长	电视剧
老冯日记	电视剧
神探方天谬	电视剧
方谬神探	电视剧
太监五虎	电视剧
Short End of The Stick	电视剧
公公出宫	电视剧
警花档案II	电视剧
Armed Reaction II	电视剧
香港警察	电视剧
Detective Investigation Files Ⅱ	电视剧
Ghetto Justice	电视剧
无敌先锋	电视剧
都市刑警	电影&电视剧
Cold Blood Warm Heart	电视剧
Tin dei nam yee	电视剧
四大娘子	电视剧
Colorful Life	电视剧
锦绣良缘	电影&电视剧
The Dance of Passion	电视剧
Virtues of Harmony	电视剧
皆大欢喜古装版	电视剧
Lord of Shanghai	电视剧
枭雄	电视剧
新孟丽君传奇	电视剧
再生缘	电影&电视剧
Secrect of The Heart	电视剧
Eye In The Sky	电视剧
天眼	电影&电视剧
射雕英雄传之九阴真经	电视剧
传爱事务所	电视剧
Will Power	电视剧
My Dangerous Mafia Retirement Plan	电视剧
舞室保卫战	电视剧
Never Dance Alone	电视剧
Fashion War	电视剧
潮流教主	电视剧
斗气冤家好兄弟	电视剧
The Fixer	电影&电视剧
The Hippocratic Crush 2	电视剧
鱼跃在冬季	电视剧
鱼跃在花见之朝	电视剧
A Fistful of Stances	电视剧
ICAC追缉令	电视剧
搞鬼辦公室	电视剧
Ghost of Relativity	电视剧
鬼同你OT	电视剧
Revolving Door of Vengeance	电视剧
酒店风云	电视剧
Who Is The Winner没找到
胜者为王	电影&电视剧
Conscience	电影
Curse of the Royal Harem	电视剧
牛头爱搭马嘴	电视剧
Officer Geomancer	电视剧
Quid Pro Quo	电视剧
御医大人	电视剧
The Last Healer In Forbidden City	电视剧
Karma	电影
Every Step You Take	电影&电视剧
逆战塘西	电视剧
收规华的良心	电视剧
法网群英	电视剧
Lethal Weapons of Love and Passion	电视剧
One Good Turn Deserves Another	电影&电视剧
Plain Love II	电视剧
大内群英	电视剧
Angle In-the-Making	电视剧
Land Of Wealth	电视剧
Bounty Lady	电视剧
My盛Lady	电视剧
The New Adventures of Wisely	电视剧
卫斯理传奇	电影&电视剧
情迷海上花	电视剧
vengeance没找到
火玫瑰	电视剧
Beauty At War没找到
Silver Spoon, Sterling Shackles	电视剧
绝世倾情	电视剧
The Legendary Ranger	电视剧
Love And Passion	电视剧
赌王天尊	电视剧
Blood Of Good And Evil	电视剧
小宝传奇	电视剧
天赐良儿	电视剧
Ten Brothers	电影&电视剧
十兄弟	电影&电视剧
Always And Ever	电视剧
蔡锷与小凤仙	电视剧
A Matter of Business	电视剧
OL Supreme	电视剧
The Queen of the Office	电视剧
夺宝奇缘	电视剧
人生马戏团	电视剧
斗谎奇缘	电视剧
Game of Deceit	电视剧
老婆大人	电影&电视剧
誓不低头	电影&电视剧
明争暗斗	电视剧
Ghost Dragon of Cold Mountain	电视剧
古灵精探Ⅱ	电视剧
搜下留情	电视剧
会友镖局	电视剧
Safe Guards	电视剧
The Pride Of Teochew	电视剧
Healing Hands	电影&电视剧
完美状妈	电视剧
Heroic Legend of the Yang's Family没找到
刘三好	电视剧
Beyond The Realm Of Conscience	电视剧
麦太扭花臣（港）	电视剧
麦太家居万能侠	电视剧
法证先锋Ⅲ没找到
Forensic Heros III	电视剧
Justice Sung Ⅱ	电视剧
灵异侦缉档案II	电视剧
熊猫教授说……	电视剧
成语动画廊	电视剧
The Gem of Life	电视剧
Chu kwong bo hei	电视剧
日月神剑续集之圣战风云	电视剧
魔煞	电视剧
捉妖奇兵	电视剧
A Taste Of Love	电视剧
少女慈禧	电视剧
警花档案III	电视剧
Armed Reaction III	电视剧
胜雪盐栈	电视剧
伙头智多星	电视剧
Chung muk ching yuen	电视剧
Man's Best Friend	电影
The File of Justice Ⅲ	电视剧
嫲辣甜孙	电视剧
Best Selling Secrets	电视剧
血荐轩辕	电视剧
Sergeant Tabloid	电视剧
陈真	电影&电视剧
Captain Of Destiny	电视剧
张保仔	电影&电视剧
The Duke of Mount Deer	电视剧
Outburst	电影&电视剧
Legend of the Demigods	电视剧
搜神传	电视剧
楚留香	电影&电视剧
Dream Of Colours	电视剧
布袋和尚	电视剧
非常保镖	电视剧
The Other Side Of The Horizon没找到
魔域桃源	电视剧
Healing Hands II	电视剧
A Pillow Case of Mystery	电视剧
施公奇案	电视剧
Fist Of Fury	电视剧
Untraceable Evidence Ⅱ	电视剧
Money Just Can't Buy没找到
天降财神	电影&电视剧
The Life And Times of A Sentinel没找到
紫禁惊雷	电视剧
King Of Yesterday and Tomorrow	电视剧
九五至尊	电视剧
Dicey Business	电视剧
To Catch The Uncatchable	电视剧
To Love With No Regrets	电视剧
足秤老婆八两夫	电视剧
Come on, Cousin没找到
老表，你好野2	电视剧
老表，你好Hea！	电视剧
水月传奇	电视剧
The Legendary Four Aces	电视剧
憨夫成龙2	电视剧
Life Made Simple没找到
A Good Match From Heaven	电视剧
奇幻潮	电视剧
Tiger Cubs	电视剧
大话情人	电影&电视剧
Bottled Passion	电视剧
But dou san hung	电视剧
Bei dou shuang xiong	电视剧
San jaat si hing	电视剧
Police Cadet	电视剧
新扎师兄	电影&电视剧
Wars of Bribery	电视剧
Heart of Greed	电视剧
情迷黑森林	电视剧
ICAC Investigators 2011	电视剧
The Return of the Condor Heroes	电视剧
The Criminal Investigator Ⅱ	电视剧
O gei sut lok Ⅱ	电视剧
O记实录Ⅱ	电视剧
勇往直前	电影&电视剧
the swordsman没找到
一切从心开始	电视剧
A Change Of Heart	电视剧
Mystery of the Twin Swords	电视剧
Perish In Name Of Love	电视剧
Greed Mask	电视剧
Square Pegs	电影&电视剧
双面伊人	电影&电视剧
Legal Entanglement	电视剧
师奶师爷	电视剧
TVB太极	电视剧
武林幸运星	电视剧
斗气天使路	电视剧
Survivor's Law	电视剧
La Femme Desperado	电视剧
蜀山奇侠之紫青双剑	电视剧
蜀山奇侠	电视剧
Young Charioteers	电视剧
The File of Justice IV	电视剧
Tim suen yea yea	电视剧
My Family没找到
On the Edge	电影
情定阴阳界没找到
撞到正	电影&电视剧
The Legend Of Lady Yang	电视剧
杨贵妃	电影&电视剧
The Mark of Triump	电视剧
客家女人	电视剧
Hakka Women	电视剧
A Handful of Love	电影&电视剧
一屋两家三姓人	电视剧
千秋英烈传	电视剧
儿女英雄传	电影&电视剧
The Last Breakthrough	电视剧
Cest la vie, mon chéri	电影&电视剧
新不了情	电影&电视剧
All That Is Bitter Is Sweet	电视剧
绝代双骄	电影&电视剧
State of Divinity	电视剧
Twilight Investigation	电视剧
Nothing to Declare	电影&电视剧
Tiger Cubs II	电视剧
云海翻腾孙悟空	电视剧
再向虎山行	电视剧
Till When Do Us Part没找到
我的野蛮婆婆	电视剧
The Academy没找到
A RECIPE FOR THE HEART	电视剧
当女人爱上男人	电视剧
只有您	电视剧
Only You 只有您	电视剧
与狼共枕	电视剧
Healing Hands III	电视剧
The Emissary	电视剧
猎鹰	电影&电视剧
中神通王重阳没找到
The Hippocratic Crush	电视剧
Sou hat yi	电视剧
su qi er	电视剧
苏乞儿	电影&电视剧
Rural Hero	电视剧
Siu mo kong wu	电视剧
xiao ao jiang hu	电视剧
Karma Rider	电视剧
東方教母	电视剧
东方母亲	电视剧
缺宅男女	电视剧
牛郎织女	电影&电视剧
烈火雄心2浴火英雄	电视剧
Burning Flame II	电视剧
宫心计2公主嫁到	电视剧
宫心计2公主出巡	电视剧
Into Thin Air	电影&电视剧
Yan gan ching fat	电视剧
Point of No Return	电影&电视剧
酒是故乡醇	电视剧
亲恩情未了	电视剧
杏林心处	电视剧
A Great Way To Care	电视剧
Just Love II	电视剧
老婆大人II	电视剧
真心英雄	电影&电视剧
The Threshold Of A Persona	电视剧
ID精英	电视剧
A Bride For A Ride	电视剧
智勇师爷斗娇妻	电视剧
机智师爷斗娇妻	电视剧
The Winter Melon Tale	电视剧
大冬瓜	电影&电视剧
A Pillow Case of Mystery 2	电视剧
施公奇案II	电视剧
千王之王重出江湖	电视剧
Wax and Wane	电视剧
团圆	电影&电视剧
Shine On You	电视剧
青出于蓝	电影&电视剧
The Comeback Clan	电视剧
美味风云	电影&电视剧
Yummy Yummy	电视剧
Justice Sung	电视剧
Forrest Cat	电视剧
新西游记	电影&电视剧
安全第一	电视剧
Crimson Sabre	电视剧
突围行动	电视剧
The File of Justice V	电视剧
The File of Justice	电视剧
壹号皇庭	电视剧
Brick Slaves	电视剧
无名天使3D	电视剧
花样中年	电视剧
Devil's Disciples	电视剧
强剑	电视剧
Divas in Distress	电视剧
男大当婚	电影&电视剧
分岔路上的他和她	电视剧
Lo gong maan sui	电视剧
My Better Half	电影&电视剧
Sister of Pearl	电视剧
武则天	电影&电视剧
A Change of Destiny	电视剧
天机算	电视剧
Golden Faith	电视剧
古墓遗书	电视剧
Anti-Crime Squad	电视剧
穆桂英大破天门阵没找到
The Confidant	电影&电视剧
黄浦倾情	电视剧
黄埔倾情	电视剧
曹氏三雄之洛神	电视剧
Where The Legend Begins	电视剧
洛神	电影&电视剧
大唐龙珠	电视剧
天蚕变之再与天比高	电视剧
Daddy Good Deeds	电视剧
War and Destiny	电视剧
少林义士洪熙官	电视剧
The Last Steep Ascent	电视剧
燃情阻击	电视剧
Friendly Fire	电影&电视剧
A Great Way to Care II	电视剧
警花档案IV	电视剧
Armed Reaction IV	电视剧
food of love	电视剧
阖府统请	电视剧
A Tough Side of A Lady	电视剧
花木兰	电影&电视剧
Witness to a Prosecution	电视剧
The Charm Beneath	电视剧
Some Day	电视剧
商战	电影&电视剧
Over Achievers	电视剧
The Romantic Swordsman	电视剧
乌龙大状师	电影&电视剧
Interpol	电影&电视剧
Fate Twisters	电视剧
盗亦有道	电影&电视剧
Catch Me Now没找到
The Price of Greed	电视剧
千谎百计	电视剧
Taming Of The Princess	电视剧
醉打金枝	电影&电视剧
deadly protection	电视剧
ICAC Investigators 2009	电视剧
廉政行动2009	电视剧
The Legend of the Condor Heroes	电视剧
Vigilante Force	电视剧
Master of Play	电视剧
Scent of Love	电影&电视剧
高朋满座	电影&电视剧
Highs and Lows	电影&电视剧
同捞同煲	电影&电视剧
林世荣	电影&电视剧
Lady Flower Fist	电视剧
Mystery Files	电视剧
Shades Of Truth	电视剧
The File of Justice Ⅱ	电视剧
Corner the Con Man	电视剧
齐天大圣	电视剧
천녀유혼	电视剧
同心生死约	电视剧
Burning Flame	电视剧
雪山飛狐	电视剧
正气	电视剧
警花档案I	电视剧
Armed ReactionⅠ	电视剧
The Legendary Fok	电视剧
洪武双雄	电视剧
Relic of an Emissary	电视剧
新扎师兄1985	电影
San jaat si hing - juk jaap	电影
新扎师兄续集	电影
Yes Sir, Sorry Sir	电视剧
狱焰惊情	电视剧
Phoenix Rising	电视剧
兰花劫	电视剧
割鹿刀	电视剧
Wars of In-Laws II	电视剧
谈判高手	电视剧
Take My Word For It没找到
Season of Love没找到
Old Time Buddy	电视剧
Beauty Pageant	电视剧
凤凰传说	电视剧
Chor hong gil hung	电视剧
The Conqueror's Story	电视剧
Happy Ever After	电影
神枪狙击2013	电视剧
Sniper Standoff	电视剧
法网嚣雄	电视剧
Awfully Lawful	电视剧
庙街妈兄弟	电视剧
Witness to a Prosecution 2	电视剧
吃醋岳父	电视剧
斗气天使路2	电视剧
律政新人王2	电视剧
律政新人王II	电视剧
秋香怒点唐伯虎	电视剧
金装豪门	电视剧
金钱诱罪	电视剧
金钱本色	电影&电视剧
布衣大侠	电视剧
布衣神相	电视剧
It Runs In The Family	电影&电视剧
孖仔孖心肝	电视剧
占星情缘	电视剧
铁嘴银牙	电视剧
Word Twisters Adventures	电视剧
反恐特勤队	电影&电视剧
ATF反恐	电视剧
Shanghai Beach	电视剧
With Or Without You没找到
东坡家事	电视剧
Twin of Brothers	电视剧
Hok king chiu kik	电视剧
E.U.没找到
Men with No Shadows	电视剧
The Shell Game	电影&电视剧
千王之王	电影&电视剧
Against The Blade Of Honour	电视剧
Miss Cool外传	电视剧
Witness Insecurity	电视剧
八仙过海	电影&电视剧
Fly With Me没找到
Fei nui ching cheun	电视剧
King Maker	电视剧
造王者	电视剧
阴阳魔王	电视剧
天地传说系列之鱼美人	电视剧
射雕英雄传之南帝北丐	电视剧
D.I.E.没找到
盗海奇兵	电视剧
烈火狂奔	电视剧
Kum pai bing yan	电视剧
Better Halves	电影&电视剧
最美丽的第七天	电视剧
甜言蜜语	电影&电视剧
A Place of One's Own	电影&电视剧
大澳的天空	电视剧
倚天屠龍記	电视剧
The New Heaven Sword and the Dragon Sabre	电视剧
Yang ka cheung	电视剧
杨家将	电影&电视剧
Return of the Cuckoo	电视剧
大亨恩怨	电视剧
Lau man dai hung	电视剧
紫禁城风云	电视剧
The Romance of the White-Hair Maiden	电视剧
The Vigilante In The Mask	电视剧
婚前昏后	电视剧
Ghetto Justice 2	电视剧
官场浮世绘	电视剧
Noblesse Oblige	电视剧
阿斯兰战记：风尘乱舞	电视剧
亚尔斯兰战记 第二季	电视剧
Food Wars: Shokugeki no Soma	电视剧
Shokugeki no Soma	电视剧
斯坦因之门	电视剧
Steins;Gate	电视剧
只有我不在的街道	电影&电视剧
The Town Where Only I Am Missing	电视剧
暖心手账	电视剧
温情点滴	电视剧
杂烩武士	电视剧
琉球狂侍	电视剧
冰果	电视剧
篮球飞人	电视剧
男儿当入樽(港)	电视剧
Slam Dunk没找到
Your Lie in April	电影&电视剧
Shigatsu wa Kimi no Uso	电视剧
赏金猎人	电影&电视剧
宇宙牛仔	电视剧
ナイティワンデイス	电视剧
腐男子高校生活	电视剧
She and Her Cat Everything Flows	电视剧
这个美术社大有问题！	电视剧
重返17岁	电影
Neon Genesis Evangelion	电影&电视剧
New Century Evangelion	电视剧
枪弹辩驳3	电视剧
不愉快的妖怪庵	电视剧
怪物庵宝宝不开心	电视剧
攻壳机动队 S.A.C. Ghost in the Shell: Stand Alone Complex	电视剧
狐忍	电影
Naruto	电影
自新世界	电影&电视剧
From the New World	电视剧
日常	电视剧
四叠半宿舍，青春迷走	电视剧
Daily Lives of High School Boys	电视剧
甲铁城的卡巴内里	电视剧
甲铁城的尸人	电视剧
烙印战士	电视剧
Berserk	电视剧
Inuyasha	电视剧
Natsume's Book of Friends 3	电视剧
Barakamon	电视剧
神奇宝贝	电影
口袋怪兽	电影
オレンジ没找到
新驱魔少年	电视剧
D.Gray-man	电视剧
格雷少年	电视剧
Naruto Shippuuden	电影
Assassination Classroom	电影&电视剧
Ansatsu Kyoushitsu	电视剧
章鱼老师	电视剧
代号D机关	电影&电视剧
Joker Game	电影&电视剧
Chibi Maruko-chan	电影&电视剧
Code Geass 反叛的魯路修	电视剧
叛逆的魯魯修	电视剧
新全职猎人	电视剧
续 夏目友人帐	电视剧
东方仗助-浪漫伝奇-深红の秘伝说―	电视剧
JoJo no Kimyo na Boken: Diamond is unbreakable	电视剧
蜂蜜幸运草(台)	电视剧
蜂蜜与幸运草	电视剧
Honey And Clover	电影
亚人 TV版	电视剧
北极熊café	电视剧
白熊咖啡厅	电视剧
青涩文学	电视剧
Hoozuki no Reitetsu	电视剧
Gintama°	电视剧
Flying Witch	电视剧
Kureyon Shin-chan	电影
元气少女缘结神OVA：过去篇	电视剧
光之棋	电视剧
Hikaru no go	电视剧
我系西瓜刨(港)	电视剧
Kamisama Hajimemashita	电影&电视剧
荒川爆笑团 第一部	电视剧
野良神 荒事	电视剧
ノラガミ 2期	电视剧
科学超电磁炮	电视剧
To Aru Kagaku no Railgun	电视剧
初恋monster	电视剧
Boku no hero academia	电视剧
My Hero Academia	电视剧
数码暴龙	电视剧
Digimon: Digital Monsters	电视剧
毒辣辣辣	电视剧
头丢啦啦啦	电视剧
Kids on the Slope	电视剧
ebichu	电视剧
世上的另一个我	电影&电视剧
NANA	电影
剣风伝奇	电视剧
极速老师	电视剧
Bleach	电影
百变小樱魔术卡	电视剧
库洛魔法使	电视剧
召唤恶魔	电视剧
You're Being Summoned, Azazel-san	电视剧
Kemonozume	电视剧
文豪Stray Dogs	电视剧
Honey & Clover II没找到
蜂蜜与四叶草 2	电视剧
Space Patrol Luluco	电视剧
妖怪联络簿 四(台)	电视剧
夏目友人帐Ⅳ	电视剧
排球！！ 第二季	电视剧
求恋期	电影&电视剧
Fooly Cooly	电视剧
Hanasaku Iroha	电视剧
鲜花盛开的色彩	电视剧
クラナド	电视剧
转吧！企鹅罐(台)	电视剧
影子篮球员	电视剧
幻影篮球王	电视剧
天元突破红莲之眼	电视剧
天元突破 グッレン ラガン	电视剧
中二病也想谈恋爱！(港)	电视剧
Chuunibyou Demo Koi ga Shitai!	电视剧
攻壳机动队 S.A.C. 2nd GIG	电视剧
Ghost in the Shell: S.A.C. 2nd GIG	电视剧
Madoka★Magica	电视剧
魔法少女魔户香	电视剧
Kyoukai no Kanata	电视剧
Uchouten Kazoku	电视剧
The Eccentric Family	电视剧
らきすた	电视剧
我家有个鱼干妹	电视剧
K-project	电视剧
关公说事 第二季	电视剧
斩服少女	电视剧
Kill La Kill没找到
Kuro no Keiyakusha	电视剧
斩！赤红之瞳	电视剧
Akame ga Kiru!	电视剧
命运之夜UBW	电视剧
命运之夜重制版	电视剧
祝福这个美好的世界！	电视剧
爆漫王。2	电视剧
爆漫。2	电视剧
好想告訴你	电视剧
天使的脉动(台)	电视剧
爆走兄弟	电视剧
Bakusou Kyoudai Let's & Go	电视剧
Panty & Stocking with Garterbelt	电视剧
死亡游戏	电影
Death Parade	电视剧
Dragon Ball Super	电视剧
千早之歌	电视剧
歌牌情缘	电视剧
白银之匙	电视剧
Silver Spoon	电影&电视剧
虎X龙	电视剧
宇宙浪子(港)	电视剧
Space Dandy	电视剧
你和我 第一季	电视剧
少年同盟 第一季	电视剧
悠悠哉哉少女日和	电视剧
哝哝日和	电视剧
Shôjo kakumei Utena	电视剧
Revolutionary Girl Utena	电视剧
小天使	电影
海蒂	电影
逆转裁判 动画版	电视剧
Michiko To Hatchin	电视剧
Basilisk: Kôga ninpô chô	电视剧
逆境无赖KAIJI	电视剧
逆境无赖开司	电视剧
Ani*Kuri15	电视剧
Anikuri15	电视剧
Yamishibai	电视剧
兔子软糖	电视剧
The Future Diary	电视剧
みらいにっき	电视剧
企业佣兵	电视剧
Serial Experiments Lain	电视剧
邻家女孩	电影&电视剧
棒球小子	电影&电视剧
美少女战士第一季	电视剧
美少女戰士初代	电视剧
Concrete Revolutio 超人幻想没找到
HareGuu	电视剧
奏响吧！上低音号没找到
Ayakashi	电视剧
White Album 2	电视剧
Gyagu Manga Biyori	电视剧
邻座的关君	电视剧
邻座同学是怪咖	电视剧
JOJO的奇妙冒险	电视剧
ジョジョの きみょうな ぼうけん	电视剧
蓝色驱魔师	电视剧
Sakurasou no Pet na Kanojo	电视剧
Tenisu no ôjisama	电视剧
Prince of Tennis	电视剧
银河骑士传	电视剧
Knights of Sidonia	电视剧
Kino no Tabi: the Beautiful World	电视剧
キノの旅: the Beautiful World	电视剧
闪烁的青春	电影&电视剧
Ao Haru Ride	电视剧
12 kokuki	电视剧
The Twelve Kingdoms	电视剧
Suzumiya Haruhi no Yuuutu	电视剧
浪客剑心之追忆篇	电视剧
浪客剑心 明治剑客浪漫谭：追忆编	电视剧
轻音	电视剧
K-On!	电视剧
命运之夜UBW 第二季	电视剧
命运之夜重制版 第二季	电视剧
圣斗士	电视剧
Knights of the Zodiac	电视剧
Saraiya Goyou	电视剧
House of Five Leaves	电视剧
某科学的超电磁炮 第二季	电视剧
科学超电磁炮S	电视剧
Katekyo Hitman Reborn	电视剧
家庭教師REBORN	电视剧
Kindaichi shônen no jiken bo	电视剧
Young Kindaichi's Casebook	电视剧
Shigurui	电视剧
神龙斗士	电视剧
魔神英雄坛	电视剧
角質層偵探因幡	电视剧
鎧傳	电视剧
铠传——武士军团	电视剧
爆漫王。	电视剧
爆漫。	电视剧
ワーキング!!没找到
白银之匙 第二季	电视剧
Silver Spoon Season 2	电视剧
幻界战线	电视剧
Kekkai Sensen	电视剧
LEVEL E	电视剧
重金摇滚双面人	电影&电视剧
重金属摇滚双面人	电视剧
Detroit Metal City	电影
Karas	电视剧
阿斯兰战记	电影&电视剧
Arslan Senki	电视剧
Shiki	电视剧
无头骑士异闻录 ×2	电视剧
无头骑士异闻录×2	电视剧
百无一用意呆利	电视剧
废柴意大利	电视剧
KAIBA	电视剧
地狱之歌	电视剧
皇家国教骑士团	电视剧
水泳部	电视剧
男子水泳部	电视剧
Free!	电视剧
Sayonara Zetsubou-Sensei	电视剧
再见！绝望老师	电视剧
轻音少女2	电视剧
K-ON!!	电视剧
明星学生妹(港)	电视剧
LoveLive! 校园偶像计划	电视剧
我的妹妹不可能这么可爱	电视剧
Ore no imouto ga konna ni kawaiiwake ga nai	电视剧
某魔术的禁书目录	电视剧
传说中魔术的禁书目录	电视剧
Initial D: First Stage	电视剧
キャッツ♥アイ	电视剧
Cat's Eye	电视剧
Spice and Wolf	电视剧
Ôkami to kôshinryô	电视剧
电脑COIL	电视剧
Gudetama	电影
Nisemonogatari	电视剧
弱虫脚踏板	电视剧
爆漫王。3	电视剧
爆漫。3	电视剧
光能使者	电视剧
大无敌	电视剧
のんのんびより 2期	电视剧
悠哉日常大王 Repeat	电视剧
银河骑士传 第二期	电视剧
Knights of Sidonia　Battle for Planet Nine	电视剧
恶之花	电影&电视剧
Flowers of Evil	电影&电视剧
JOJO的奇妙冒险 星尘十字军	电视剧
JOJO的奇妙冒险 TV版 第二季	电视剧
mayoiga	电视剧
迷家-マヨイガ-	电视剧
迷家	电视剧
明星学生妹Ⅱ(港)	电视剧
LoveLive! 校园偶像计划 第二季	电视剧
翠星的伽鲁冈缇亚	电视剧
Gargantia on the Verdurous Planet	电视剧
熟女的时间	电视剧
Aldnoah.Zero	电视剧
不起眼女主角培育法	电视剧
Saenai Heroine No Sodatekata	电视剧
鸟之诗	电视剧
青空下的传说	电视剧
电光快车侠	电视剧
Japan Hikarian Railroad	电视剧
Owarimonogatari	电视剧
Space Dandy Season 2	电视剧
機動戦士ガンダムSEED	电视剧
Mobile Suit Gundam Seed	电视剧
Seirei no Moribito	电视剧
即使如此小镇还是转个不停	电视剧
即使如此小镇依然转动	电视剧
我不受欢迎，怎么想都是你们的错！	电视剧
丧女	电视剧
钻A	电视剧
Dia no Ace	电视剧
Psychic Detective Yakumo	电视剧
机动战士Gundam 0080 口袋里的战争没找到
机动战士钢弹UC(台)	电视剧
Mobile Suit Gundam Unicorn	电视剧
Terra Formars	电影&电视剧
Student Council Staff Members	电视剧
Seitokai Yakuindomo	电视剧
我的妹妹不可能这么可爱2	电视剧
GREAT TEACHER ONIZUKA	电视剧
口袋妖怪XY	电视剧
神奇宝贝XY	电视剧
天体战士桑雷德	电视剧
Astro Fighter Sunred	电视剧
The Tale of Genji	电影&电视剧
Genji monogatari sennenki: Genji	电视剧
Minamike	电视剧
Minami-ke	电视剧
フェアリーテール	电视剧
笨蛋，测试，召唤兽	电视剧
怪盗St. Tail(港)	电视剧
圣少女	电视剧
天方魔谭MAGI	电视剧
魔笛MAGI	电视剧
Dibetagurashi Ahiru no Seikatsu	电视剧
It is living happily on ground every day	电视剧
石膏Boys	电视剧
中二病也要谈恋爱！ 第二季	电视剧
中二病也要恋爱！恋	电视剧
心连‧情结(台)	电视剧
心灵链环	电视剧
期待在地下城邂逅有错吗	电视剧
Your Lie in April OAD: Moments	电视剧
Shigatsu wa Kimi no Uso OAD: MOMENTS	电视剧
Plastic Memories	电视剧
Forest Boy	电视剧
控制	电影
金钱掌控	电视剧
濑户的新娘	电视剧
Seto no Hanayome	电视剧
My Love Story没找到
Ore Monogatari	电影&电视剧
Toshokan Sensō	电视剧
Library War	电视剧
日本动画人博览会	电视剧
MACROSS DELTA	电视剧
超时空要塞△	电视剧
機動戰士Gundam0083：STARDUST MEMORY	电视剧
Mobile Suit GUNDAM0083 STARDUST MEMORY	电视剧
Gurimu meisaku gekijou	电视剧
Grimm Masterpiece Theatre	电视剧
Read or Die	电视剧
Suzumiya Haruhi chan no yûutsu	电视剧
RDG红皮书女孩	电视剧
ALDNOAH.ZERO 第2期	电视剧
Kore wa Zombie Desuka?	电视剧
这样算是僵尸吗？	电视剧
攻壳机动队：塔奇克马的日常没找到
Tachikoma na hibi	电视剧
昆虫物语 孤儿小哈奇	电视剧
小蜜蜂寻母记	电视剧
起司猫2	电视剧
Chi's New Address チーズスイートホーム	电视剧
因果侦探	电视剧
UN-GO	电视剧
Pandora Hearts	电视剧
潘多拉之心	电视剧
十二生肖 爆烈戰士	电视剧
The Twelve Warriors Bakuretsu Eto-ranger	电视剧
GetBackers	电视剧
闪灵夺还屋	电视剧
Kamisama no Memo Chou	电视剧
God's Notebook	电视剧
怪盗基德	电视剧
神偷怪盗(台)	电视剧
霹雳酷乐猫	电视剧
サイボーグクロちゃん	电视剧
Time bokan	电视剧
超时空要塞 边界	电视剧
超时空要塞 开拓者	电视剧
美少女战士第三季	电视剧
Bishoujo Senshi Sailor Moon	电视剧
最近我的妹妹有点怪	电视剧
Recently, my sister is unusual.	电视剧
ダイヤのA 2期	电视剧
Diamond No Ace	电视剧
三目童子	电视剧
三眼小子	电视剧
Ano Natsu de Matteru	电视剧
Is The Order A Rabbit??	电视剧
废柴意大利 第4期	电视剧
The Secret Garden	电影
秘密花园	电影&电视剧
魔鬼爱人	电视剧
大菠萝爱人	电视剧
薄樱鬼 第二季	电视剧
薄樱鬼 ～新选组奇谭～第二季	电视剧
神奇宝贝超世代	电视剧
ポケットモンスター アドバンスジェネレーション	电视剧
TV ANIMATION BLACK☆ROCK SHOOTER	电视剧
告诉我！小辣妹！	电视剧
告诉我！辣妹子酱	电视剧
家族鲁宾逊漂流记 不可思议之岛的芙劳拉	电视剧
新鲁宾逊漂流记	电视剧
长门有希酱的消失	电视剧
Kochira Katsushika-ku Kamearikouen-mae Hashutsujo	电视剧
Kochikame	电视剧
金田一少年事件簿2014	电视剧
金田一少年之事件簿R	电视剧
笑对昙天	电视剧
笑对阴天	电影&电视剧
笑傲云天	电影
骑士德恩	电视剧
双面骑士	电视剧
骑士	电影
美少女战士 第四季	电视剧
美少女战士SS	电视剧
功夫小子金米	电视剧
铁拳小子	电影&电视剧
死亡的思考	电视剧
包剪槌小飞侠(港)	电视剧
Jankenman	电视剧
Wagaya no Oinari-sama.	电视剧
汽车奔奔	电视剧
嘿！笨笨	电视剧
阿鹤公主	电视剧
甩绳公主	电视剧
Tokimeki Tonight	电视剧
心跳晚上	电视剧
夏日阳光	电视剧
魔法使派遣会社	电视剧
魔法使借贷公司	电视剧
出租魔法使没找到
宇宙海盗	电视剧
魔人侦探食脑奈罗	电视剧
魔力女仆	电视剧
幻影	电影
纯情罗曼史 第三季	电视剧
2J火力以下枪战社	电视剧
Sabagebu!	电视剧
Binbou-gami ga!	电视剧
穷神(台)	电视剧
IQ博士	电视剧
怪博士与机器娃娃	电影&电视剧
Yugo	电视剧
疾走王子Alternative	电视剧
Prince of STRIDE	电视剧
Acchi kocchi	电视剧
now and then, here and there没找到
超时空幻境	电视剧
Mobile Suit Gundam Thunderbolt	电视剧
Gatchaman Crowds	电视剧
神勇飞鹰侠Crowds	电视剧
Umineko no Naku Koro ni	电视剧
秋蝉鸣泣之时·礼	电视剧
寒蝉鸣泣之时 OVA	电视剧
Tsukimonogatari	电视剧
K 诸王归来	电视剧
When Supernatural Battles Became Commonplace	电视剧
ハナモノガタリ	电视剧
Hanamonogatari	电视剧
创圣之阿克艾利欧没找到
美少女战士第二季	电视剧
Pretty Soldier Sailor Moon R	电视剧
数码暴龙3：驯兽师之王	电视剧
数码兽驯兽师	电视剧
罗德斯岛战记：灰色魔女传	电视剧
罗德岛战记OVA	电视剧
小森拒绝不了	电视剧
小森同学拒绝不了	电视剧
四月一日灵异记事簿2	电视剧
次元魔女2	电视剧
Scrapped Princess	电视剧
最游记 第一部	电视剧
Gensomaden Saiyuki	电视剧
Ranma Nibun no Ichi	电视剧
Ranma 1	电视剧
罪与罚与赎的少女	电视剧
海底两万里	电影&电视剧
不可思议的海之娜蒂亚	电视剧
旧哆啦	电视剧
机器猫	电影&电视剧
小叮当	电影
英雄世纪	电视剧
果酱男孩	电视剧
妖狐X僕SS	电视剧
Genji Monogatari	电视剧
少女爱上了少女没找到
Kashimashi: Girl Meets Girl没找到
旋旋喵	电视剧
来来猫	电视剧
搞笑漫画日和 第3期	电视剧
全金属狂潮校园篇	电视剧
Full Metal Panic! The Second Raid	电视剧
全金属狂潮3二度冲击	电视剧
甄嬛传	电影&电视剧
三国演义	电影&电视剧